pwmcount, residuebefore, residueafter,diff,voltbefore,voltafter,voltdiff 
5,1868,2186,-318,1.505,1.761,-0.256
5,2234,1509,725,1.800,1.216,0.584
5,1544,1904,-360,1.244,1.534,-0.290
5,1923,1924,-1,1.549,1.550,-0.001
5,1968,2017,-49,1.585,1.625,-0.039
5,2062,1854,208,1.661,1.494,0.168
5,1887,1992,-105,1.520,1.605,-0.085
5,2037,2032,5,1.641,1.637,0.004
5,2075,1727,348,1.672,1.391,0.280
5,1763,1767,-4,1.420,1.423,-0.003
5,1802,1555,247,1.452,1.253,0.199
5,1589,2207,-618,1.280,1.778,-0.498
5,2252,1574,678,1.814,1.268,0.546
5,1609,2019,-410,1.296,1.626,-0.330
5,2064,1554,510,1.663,1.252,0.411
5,1587,1811,-224,1.278,1.459,-0.180
5,1844,1959,-115,1.485,1.578,-0.093
5,2003,2057,-54,1.614,1.657,-0.044
5,2102,1952,150,1.693,1.573,0.121
5,1995,2256,-261,1.607,1.817,-0.210
5,2302,1689,613,1.854,1.361,0.494
5,1723,2033,-310,1.388,1.638,-0.250
5,2076,2026,50,1.672,1.632,0.040
5,2073,2282,-209,1.670,1.838,-0.168
5,2327,1930,397,1.875,1.555,0.320
5,1949,1961,-12,1.570,1.580,-0.010
5,2006,1705,301,1.616,1.374,0.242
5,1738,1795,-57,1.400,1.446,-0.046
5,1828,2129,-301,1.473,1.715,-0.242
5,2176,1969,207,1.753,1.586,0.167
5,2012,2118,-106,1.621,1.706,-0.085
5,2164,1452,712,1.743,1.170,0.574
5,1489,1555,-66,1.200,1.253,-0.053
5,1590,2208,-618,1.281,1.779,-0.498
5,2252,1911,341,1.814,1.539,0.275
5,1932,2154,-222,1.556,1.735,-0.179
5,2200,1936,264,1.772,1.560,0.213
5,1981,1638,343,1.596,1.320,0.276
5,1671,2037,-366,1.346,1.641,-0.295
5,2082,1478,604,1.677,1.191,0.487
5,1512,2236,-724,1.218,1.801,-0.583
5,2281,1684,597,1.838,1.357,0.481
5,1719,1682,37,1.385,1.355,0.030
5,1715,1621,94,1.382,1.306,0.076
5,1655,1961,-306,1.333,1.580,-0.247
5,2005,2055,-50,1.615,1.655,-0.040
5,2099,1948,151,1.691,1.569,0.122
5,1992,1794,198,1.605,1.445,0.160
5,1827,1841,-14,1.472,1.483,-0.011
5,1874,2238,-364,1.510,1.803,-0.293
5,2282,2182,100,1.838,1.758,0.081
5,2228,1562,666,1.795,1.258,0.537
5,1595,2214,-619,1.285,1.784,-0.499
5,2258,1545,713,1.819,1.245,0.574
5,1579,1535,44,1.272,1.237,0.035
5,1570,2083,-513,1.265,1.678,-0.413
5,2128,2076,52,1.714,1.672,0.042
5,2121,2168,-47,1.709,1.747,-0.038
5,2213,1995,218,1.783,1.607,0.176
5,2040,2144,-104,1.643,1.727,-0.084
5,2188,1674,514,1.763,1.349,0.414
5,1706,1964,-258,1.374,1.582,-0.208
5,2007,2155,-148,1.617,1.736,-0.119
5,2200,1725,475,1.772,1.390,0.383
5,1759,1714,45,1.417,1.381,0.036
5,1747,1857,-110,1.407,1.496,-0.089
5,1890,1733,157,1.523,1.396,0.126
5,1765,1822,-57,1.422,1.468,-0.046
5,1855,1955,-100,1.494,1.575,-0.081
5,1999,1998,1,1.610,1.610,0.001
5,2044,1985,59,1.647,1.599,0.048
5,2029,2138,-109,1.635,1.722,-0.088
5,2184,2180,4,1.759,1.756,0.003
5,2224,1608,616,1.792,1.295,0.496
5,1641,2162,-521,1.322,1.742,-0.420
5,2208,2096,112,1.779,1.689,0.090
5,2140,1887,253,1.724,1.520,0.204
5,1921,1562,359,1.548,1.258,0.289
5,1595,2048,-453,1.285,1.650,-0.365
5,2094,2196,-102,1.687,1.769,-0.082
5,2241,1921,320,1.805,1.548,0.258
5,1965,2113,-148,1.583,1.702,-0.119
5,2160,1992,168,1.740,1.605,0.135
5,2037,1730,307,1.641,1.394,0.247
5,1765,2072,-307,1.422,1.669,-0.247
5,2115,1649,466,1.704,1.328,0.375
5,1683,1933,-250,1.356,1.557,-0.201
5,1978,1835,143,1.593,1.478,0.115
5,1868,1817,51,1.505,1.464,0.041
5,1848,1751,97,1.489,1.411,0.078
5,1784,1737,47,1.437,1.399,0.038
5,1770,2174,-404,1.426,1.751,-0.325
5,2218,1748,470,1.787,1.408,0.379
5,1782,1924,-142,1.436,1.550,-0.114
5,1970,1662,308,1.587,1.339,0.248
5,1696,1705,-9,1.366,1.374,-0.007
5,1738,2304,-566,1.400,1.856,-0.456
5,2348,2070,278,1.892,1.668,0.224
5,2114,1908,206,1.703,1.537,0.166
5,1928,1520,408,1.553,1.224,0.329
5,1554,2015,-461,1.252,1.623,-0.371
5,2057,1751,306,1.657,1.411,0.247
5,1784,2032,-248,1.437,1.637,-0.200
5,2076,1662,414,1.672,1.339,0.334
5,1695,1854,-159,1.365,1.494,-0.128
5,1887,1573,314,1.520,1.267,0.253
5,1608,1824,-216,1.295,1.469,-0.174
5,1858,1652,206,1.497,1.331,0.166
5,1683,2089,-406,1.356,1.683,-0.327
5,2135,2119,16,1.720,1.707,0.013
5,2164,2103,61,1.743,1.694,0.049
5,2147,1981,166,1.730,1.596,0.134
5,2028,1660,368,1.634,1.337,0.296
5,1693,1701,-8,1.364,1.370,-0.006
5,1734,1474,260,1.397,1.187,0.209
5,1509,2008,-499,1.216,1.618,-0.402
5,2052,1901,151,1.653,1.531,0.122
5,1922,1667,255,1.548,1.343,0.205
5,1700,2101,-401,1.369,1.693,-0.323
5,2146,1511,635,1.729,1.217,0.512
5,1544,2054,-510,1.244,1.655,-0.411
5,2099,1845,254,1.691,1.486,0.205
5,1879,1714,165,1.514,1.381,0.133
5,1749,1759,-10,1.409,1.417,-0.008
5,1791,1698,93,1.443,1.368,0.075
5,1730,2026,-296,1.394,1.632,-0.238
5,2070,1659,411,1.668,1.336,0.331
5,1692,1999,-307,1.363,1.610,-0.247
5,2045,2136,-91,1.647,1.721,-0.073
5,2180,2070,110,1.756,1.668,0.089
5,2114,2154,-40,1.703,1.735,-0.032
5,2200,1793,407,1.772,1.444,0.328
5,1827,2073,-246,1.472,1.670,-0.198
5,2118,1989,129,1.706,1.602,0.104
5,2036,2032,4,1.640,1.637,0.003
5,2074,2327,-253,1.671,1.875,-0.204
5,2372,2000,372,1.911,1.611,0.300
5,2043,1831,212,1.646,1.475,0.171
5,1863,1917,-54,1.501,1.544,-0.044
5,1936,1888,48,1.560,1.521,0.039
5,1921,1823,98,1.548,1.469,0.079
5,1856,1587,269,1.495,1.278,0.217
5,1621,1829,-208,1.306,1.473,-0.168
5,1863,2152,-289,1.501,1.734,-0.233
5,2198,1683,515,1.771,1.356,0.415
5,1715,2069,-354,1.382,1.667,-0.285
5,2114,2360,-246,1.703,1.901,-0.198
5,2406,2076,330,1.938,1.672,0.266
5,2120,2367,-247,1.708,1.907,-0.199
5,2413,1521,892,1.944,1.225,0.719
5,1555,1498,57,1.253,1.207,0.046
5,1532,2314,-782,1.234,1.864,-0.630
5,2358,1702,656,1.900,1.371,0.528
5,1735,1481,254,1.398,1.193,0.205
5,1517,1853,-336,1.222,1.493,-0.271
5,1886,1995,-109,1.519,1.607,-0.088
5,2039,1855,184,1.643,1.494,0.148
5,1887,1813,74,1.520,1.461,0.060
5,1849,1952,-103,1.490,1.573,-0.083
5,1996,1805,191,1.608,1.454,0.154
5,1838,1689,149,1.481,1.361,0.120
5,1721,2030,-309,1.386,1.635,-0.249
5,2076,1825,251,1.672,1.470,0.202
5,1860,1766,94,1.498,1.423,0.076
5,1799,1660,139,1.449,1.337,0.112
5,1694,2317,-623,1.365,1.867,-0.502
5,2361,1752,609,1.902,1.411,0.491
5,1785,2144,-359,1.438,1.727,-0.289
5,2190,1970,220,1.764,1.587,0.177
5,2013,1924,89,1.622,1.550,0.072
5,1944,2107,-163,1.566,1.697,-0.131
5,2152,1801,351,1.734,1.451,0.283
5,1834,1688,146,1.477,1.360,0.118
5,1722,2142,-420,1.387,1.726,-0.338
5,2186,2181,5,1.761,1.757,0.004
5,2228,2130,98,1.795,1.716,0.079
5,2176,1965,211,1.753,1.583,0.170
5,2008,1653,355,1.618,1.332,0.286
5,1687,2102,-415,1.359,1.693,-0.334
5,2147,2355,-208,1.730,1.897,-0.168
5,2400,1897,503,1.933,1.528,0.405
5,1916,2188,-272,1.544,1.763,-0.219
5,2232,1670,562,1.798,1.345,0.453
5,1704,1719,-15,1.373,1.385,-0.012
5,1751,2365,-614,1.411,1.905,-0.495
5,2411,1752,659,1.942,1.411,0.531
5,1785,1744,41,1.438,1.405,0.033
5,1779,1638,141,1.433,1.320,0.114
5,1673,1782,-109,1.348,1.436,-0.088
5,1815,2330,-515,1.462,1.877,-0.415
5,2376,1817,559,1.914,1.464,0.450
5,1851,2104,-253,1.491,1.695,-0.204
5,2147,1837,310,1.730,1.480,0.250
,,,0,0.000,0.000,0.000
5,2368,2057,311,1.908,1.657,0.251
5,1883,1569,314,1.517,1.264,0.253
5,1709,1823,-114,1.377,1.469,-0.092
5,2260,2146,114,1.821,1.729,0.092
,,,0,0.000,0.000,0.000
5,1851,2153,-302,1.491,1.734,-0.243
,,,0,0.000,0.000,0.000
5,1915,1819,96,1.543,1.465,0.077
5,1897,1551,346,1.528,1.249,0.279
5,1740,1699,41,1.402,1.369,0.033
5,2140,2038,102,1.724,1.642,0.082
5,2172,1704,468,1.750,1.373,0.377
5,1561,1873,-312,1.258,1.509,-0.251
5,2048,2044,4,1.650,1.647,0.003
5,2080,1615,465,1.676,1.301,0.375
5,1684,1527,157,1.357,1.230,0.126
5,2128,2274,-146,1.714,1.832,-0.118
5,1725,1968,-243,1.390,1.585,-0.196
5,1983,2240,-257,1.597,1.805,-0.207
5,1707,1496,211,1.375,1.205,0.170
5,1775,1570,205,1.430,1.265,0.165
5,2214,2107,107,1.784,1.697,0.086
5,1923,1820,103,1.549,1.466,0.083
5,1887,1788,99,1.520,1.440,0.080
5,1648,1711,-63,1.328,1.378,-0.051
5,2192,2020,172,1.766,1.627,0.139
5,1794,1955,-161,1.445,1.575,-0.130
5,1783,1946,-163,1.436,1.568,-0.131
5,1566,1622,-56,1.262,1.307,-0.045
,,,0,0.000,0.000,0.000
5,1747,1603,144,1.407,1.291,0.116
5,2158,2214,-56,1.738,1.784,-0.045
5,1680,1805,-125,1.353,1.454,-0.101
5,1984,1985,-1,1.598,1.599,-0.001
5,1869,1974,-105,1.506,1.590,-0.085
5,2224,2070,154,1.792,1.668,0.124
,,,0,0.000,0.000,0.000
5,2005,1597,408,1.615,1.287,0.329
5,1927,1539,388,1.552,1.240,0.313
5,2078,1675,403,1.674,1.349,0.325
5,1799,1915,-116,1.449,1.543,-0.093
5,2354,1741,613,1.896,1.403,0.494
,,,0,0.000,0.000,0.000
5,2102,1947,155,1.693,1.568,0.125
5,1564,2188,-624,1.260,1.763,-0.503
5,1814,2316,-502,1.461,1.866,-0.404
5,1579,2038,-459,1.272,1.642,-0.370
5,1961,1927,34,1.580,1.552,0.027
5,1845,2055,-210,1.486,1.655,-0.169
5,1781,1976,-195,1.435,1.592,-0.157
5,1489,1946,-457,1.200,1.568,-0.368
5,1926,1713,213,1.552,1.380,0.172
5,1926,2035,-109,1.552,1.639,-0.088
5,2074,2180,-106,1.671,1.756,-0.085
5,2106,2166,-60,1.697,1.745,-0.048
5,1688,1707,-19,1.360,1.375,-0.015
5,1931,1794,137,1.556,1.445,0.110
5,1913,2006,-93,1.541,1.616,-0.075
5,1822,1779,43,1.468,1.433,0.035
5,2368,1856,512,1.908,1.495,0.412
5,2083,2137,-54,1.678,1.722,-0.044
5,1548,2173,-625,1.247,1.751,-0.503
5,2157,1907,250,1.738,1.536,0.201
5,1873,2163,-290,1.509,1.742,-0.234
5,1516,1886,-370,1.221,1.519,-0.298
5,1589,2157,-568,1.280,1.738,-0.458
5,2140,2385,-245,1.724,1.921,-0.197
5,1841,2144,-303,1.483,1.727,-0.244
5,1855,2053,-198,1.494,1.654,-0.160
5,2082,2224,-142,1.677,1.792,-0.114
5,1927,1926,1,1.552,1.552,0.001
5,1940,1684,256,1.563,1.357,0.206
5,1963,1911,52,1.581,1.539,0.042
5,2334,1951,383,1.880,1.572,0.309
5,1916,2177,-261,1.544,1.754,-0.210
5,1988,2027,-39,1.602,1.633,-0.031
5,1527,1990,-463,1.230,1.603,-0.373
5,1855,1691,164,1.494,1.362,0.132
5,2078,1886,192,1.674,1.519,0.155
5,2114,2274,-160,1.703,1.832,-0.129
5,1985,1631,354,1.599,1.314,0.285
,,,0,0.000,0.000,0.000
5,1635,1902,-267,1.317,1.532,-0.215
5,1710,2164,-454,1.378,1.743,-0.366
5,1877,2241,-364,1.512,1.805,-0.293
,,,0,0.000,0.000,0.000
,,,0,0.000,0.000,0.000
5,1755,1713,42,1.414,1.380,0.034
5,1777,1977,-200,1.432,1.593,-0.161
5,2057,2308,-251,1.657,1.859,-0.202
,,,0,0.000,0.000,0.000
5,1854,2062,-208,1.494,1.661,-0.168
5,1518,1832,-314,1.223,1.476,-0.253
5,1528,1467,61,1.231,1.182,0.049
5,2062,1861,201,1.661,1.499,0.162
5,1621,2074,-453,1.306,1.671,-0.365
5,1936,1646,290,1.560,1.326,0.234
5,2140,1887,253,1.724,1.520,0.204
5,2063,1711,352,1.662,1.378,0.284
5,1781,2131,-350,1.435,1.717,-0.282
5,1999,1747,252,1.610,1.407,0.203
5,1817,1721,96,1.464,1.386,0.077
5,2054,1803,251,1.655,1.452,0.202
5,2394,1884,510,1.929,1.518,0.411
5,1689,2155,-466,1.361,1.736,-0.375
5,1985,1977,8,1.599,1.593,0.006
5,1962,2112,-150,1.581,1.701,-0.121
5,2249,2137,112,1.812,1.722,0.090
5,2334,1871,463,1.880,1.507,0.373
5,2258,1743,515,1.819,1.404,0.415
,,,0,0.000,0.000,0.000
5,2312,1848,464,1.863,1.489,0.374
5,2076,1951,125,1.672,1.572,0.101
5,2130,1506,624,1.716,1.213,0.503
,,,0,0.000,0.000,0.000
,,,0,0.000,0.000,0.000
5,1672,1984,-312,1.347,1.598,-0.251
,,,0,0.000,0.000,0.000
5,1918,2177,-259,1.545,1.754,-0.209
5,2003,1586,417,1.614,1.278,0.336
5,1765,1617,148,1.422,1.303,0.119
5,1749,1547,202,1.409,1.246,0.163
,,,0,0.000,0.000,0.000
5,2216,2208,8,1.785,1.779,0.006
,,,0,0.000,0.000,0.000
,,,0,0.000,0.000,0.000
,,,0,0.000,0.000,0.000
5,2418,2154,264,1.948,1.735,0.213
5,1875,2078,-203,1.510,1.674,-0.164
5,2259,1688,571,1.820,1.360,0.460
5,2226,1997,229,1.793,1.609,0.184
5,2020,2044,-24,1.627,1.647,-0.019
5,1969,2166,-197,1.586,1.745,-0.159
5,2288,2222,66,1.843,1.790,0.053
,,,0,0.000,0.000,0.000
5,1949,1871,78,1.570,1.507,0.063
5,1883,1891,-8,1.517,1.523,-0.006
5,1871,1970,-99,1.507,1.587,-0.080
5,2376,1771,605,1.914,1.427,0.487
5,2095,1789,306,1.688,1.441,0.247
5,1722,1884,-162,1.387,1.518,-0.131
,,,0,0.000,0.000,0.000
,,,0,0.000,0.000,0.000
5,1770,1501,269,1.426,1.209,0.217
,,,0,0.000,0.000,0.000
5,2416,2209,207,1.946,1.780,0.167
5,2087,1887,200,1.681,1.520,0.161
5,1893,2150,-257,1.525,1.732,-0.207
5,2085,1974,111,1.680,1.590,0.089
,,,0,0.000,0.000,0.000
5,2045,1986,59,1.647,1.600,0.048
5,2184,2018,166,1.759,1.626,0.134
5,2152,1988,164,1.734,1.602,0.132
5,1953,1768,185,1.573,1.424,0.149
5,1789,1986,-197,1.441,1.600,-0.159
5,2271,1591,680,1.829,1.282,0.548
,,,0,0.000,0.000,0.000
5,1937,1694,243,1.560,1.365,0.196
5,1966,2055,-89,1.584,1.655,-0.072
5,1810,2051,-241,1.458,1.652,-0.194
5,1814,2310,-496,1.461,1.861,-0.400
5,1815,1706,109,1.462,1.374,0.088
5,2140,2188,-48,1.724,1.763,-0.039
5,1954,2016,-62,1.574,1.624,-0.050
,,,0,0.000,0.000,0.000
5,1971,1719,252,1.588,1.385,0.203
5,2377,1996,381,1.915,1.608,0.307
5,1879,1934,-55,1.514,1.558,-0.044
5,1867,1933,-66,1.504,1.557,-0.053
5,1900,1743,157,1.531,1.404,0.126
5,1560,1769,-209,1.257,1.425,-0.168
5,1793,1933,-140,1.444,1.557,-0.113
5,2003,1540,463,1.614,1.241,0.373
5,1952,1953,-1,1.573,1.573,-0.001
5,2023,1603,420,1.630,1.291,0.338
5,1970,2113,-143,1.587,1.702,-0.115
5,2139,1966,173,1.723,1.584,0.139
5,1853,1659,194,1.493,1.336,0.156
5,1841,2353,-512,1.483,1.896,-0.412
5,2232,1721,511,1.798,1.386,0.412
5,2203,2038,165,1.775,1.642,0.133
,,,0,0.000,0.000,0.000
5,1992,2048,-56,1.605,1.650,-0.045
,,,0,0.000,0.000,0.000
,,,0,0.000,0.000,0.000
,,,0,0.000,0.000,0.000
5,2151,1799,352,1.733,1.449,0.284
5,2120,1825,295,1.708,1.470,0.238
5,1855,1760,95,1.494,1.418,0.077
5,2037,1977,60,1.641,1.593,0.048
5,2058,1659,399,1.658,1.336,0.321
,,,0,0.000,0.000,0.000
5,1511,2232,-721,1.217,1.798,-0.581
5,2218,1960,258,1.787,1.579,0.208
5,1991,1896,95,1.604,1.527,0.077
5,1809,2070,-261,1.457,1.668,-0.210
5,2249,2087,162,1.812,1.681,0.131
5,2123,2012,111,1.710,1.621,0.089
5,2248,2237,11,1.811,1.802,0.009
5,2156,1795,361,1.737,1.446,0.291
5,2019,1961,58,1.626,1.580,0.047
5,1987,1518,469,1.601,1.223,0.378
5,1640,2150,-510,1.321,1.732,-0.411
5,1694,1790,-96,1.365,1.442,-0.077
5,1837,1972,-135,1.480,1.589,-0.109
,,,0,0.000,0.000,0.000
5,1755,2112,-357,1.414,1.701,-0.288
,,,0,0.000,0.000,0.000
5,1780,1877,-97,1.434,1.512,-0.078
5,1925,1791,134,1.551,1.443,0.108
,,,0,0.000,0.000,0.000
5,1879,1980,-101,1.514,1.595,-0.081
,,,0,0.000,0.000,0.000
5,2040,2134,-94,1.643,1.719,-0.076
5,2214,1658,556,1.784,1.336,0.448
5,2349,1680,669,1.892,1.353,0.539
5,1631,2133,-502,1.314,1.718,-0.404
5,1800,1749,51,1.450,1.409,0.041
5,2172,1501,671,1.750,1.209,0.541
,,,0,0.000,0.000,0.000
5,1612,2214,-602,1.299,1.784,-0.485
5,2284,2320,-36,1.840,1.869,-0.029
,,,0,0.000,0.000,0.000
,,,0,0.000,0.000,0.000
5,2054,2002,52,1.655,1.613,0.042
,,,0,0.000,0.000,0.000
5,1862,2276,-414,1.500,1.834,-0.334
,,,0,0.000,0.000,0.000
5,2232,1968,264,1.798,1.585,0.213
5,1854,2000,-146,1.494,1.611,-0.118
5,1921,1915,6,1.548,1.543,0.005
5,2210,2247,-37,1.780,1.810,-0.030
,,,0,0.000,0.000,0.000
,,,0,0.000,0.000,0.000
,,,0,0.000,0.000,0.000
5,2218,1739,479,1.787,1.401,0.386
,,,0,0.000,0.000,0.000
5,1808,1490,318,1.456,1.200,0.256
,,,0,0.000,0.000,0.000
5,1767,1562,205,1.423,1.258,0.165
5,2148,1900,248,1.730,1.531,0.200
,,,0,0.000,0.000,0.000
5,1795,1802,-7,1.446,1.452,-0.006
,,,0,0.000,0.000,0.000
5,2412,2036,376,1.943,1.640,0.303
,,,0,0.000,0.000,0.000
5,1692,1495,197,1.363,1.204,0.159
5,2136,1475,661,1.721,1.188,0.532
5,1490,1758,-268,1.200,1.416,-0.216
5,2438,1955,483,1.964,1.575,0.389
5,1723,1676,47,1.388,1.350,0.038
5,1795,2038,-243,1.446,1.642,-0.196
5,2420,2305,115,1.950,1.857,0.093
5,2062,1537,525,1.661,1.238,0.423
,,,0,0.000,0.000,0.000
5,2010,1752,258,1.619,1.411,0.208
5,1763,1866,-103,1.420,1.503,-0.083
5,1827,2221,-394,1.472,1.789,-0.317
5,1782,1569,213,1.436,1.264,0.172
,,,0,0.000,0.000,0.000
5,1807,1656,151,1.456,1.334,0.122
5,1891,1791,100,1.523,1.443,0.081
,,,0,0.000,0.000,0.000
,,,0,0.000,0.000,0.000
5,1812,1919,-107,1.460,1.546,-0.086
,,,0,0.000,0.000,0.000
5,1642,2301,-659,1.323,1.854,-0.531
5,1753,2001,-248,1.412,1.612,-0.200
,,,0,0.000,0.000,0.000
5,1565,1871,-306,1.261,1.507,-0.247
5,2384,2104,280,1.921,1.695,0.226
5,2069,2208,-139,1.667,1.779,-0.112
5,2065,1754,311,1.664,1.413,0.251
5,2197,2238,-41,1.770,1.803,-0.033
,,,0,0.000,0.000,0.000
,,,0,0.000,0.000,0.000
,,,0,0.000,0.000,0.000
5,1976,1459,517,1.592,1.175,0.416
5,1796,1746,50,1.447,1.407,0.040
5,2079,2232,-153,1.675,1.798,-0.123
5,2058,1866,192,1.658,1.503,0.155
5,1928,1848,80,1.553,1.489,0.064
5,1662,1921,-259,1.339,1.548,-0.209
5,2048,1924,124,1.650,1.550,0.100
,,,0,0.000,0.000,0.000
5,1615,2337,-722,1.301,1.883,-0.582
5,2272,1820,452,1.830,1.466,0.364
5,1787,2093,-306,1.440,1.686,-0.247
5,2285,1821,464,1.841,1.467,0.374
5,1840,2144,-304,1.482,1.727,-0.245
5,1594,1743,-149,1.284,1.404,-0.120
5,1899,2037,-138,1.530,1.641,-0.111
5,1756,2152,-396,1.415,1.734,-0.319
,,,0,0.000,0.000,0.000
5,2136,1867,269,1.721,1.504,0.217
,,,0,0.000,0.000,0.000
5,1805,1904,-99,1.454,1.534,-0.080
5,2015,2049,-34,1.623,1.651,-0.027
5,2388,2312,76,1.924,1.863,0.061
,,,0,0.000,0.000,0.000
,,,0,0.000,0.000,0.000
5,2291,1659,632,1.846,1.336,0.509
,,,0,0.000,0.000,0.000
5,1664,1717,-53,1.340,1.383,-0.043
5,2243,2174,69,1.807,1.751,0.056
5,1834,1880,-46,1.477,1.515,-0.037
,,,0,0.000,0.000,0.000
5,2312,2032,280,1.863,1.637,0.226
5,2312,1675,637,1.863,1.349,0.513
,,,0,0.000,0.000,0.000
,,,0,0.000,0.000,0.000
,,,0,0.000,0.000,0.000
,,,0,0.000,0.000,0.000
,,,0,0.000,0.000,0.000
5,1717,1919,-202,1.383,1.546,-0.163
5,2148,2257,-109,1.730,1.818,-0.088
5,2126,2004,122,1.713,1.614,0.098
5,1975,1925,50,1.591,1.551,0.040
5,1587,1597,-10,1.278,1.287,-0.008
,,,0,0.000,0.000,0.000
5,2124,1957,167,1.711,1.577,0.135
5,2189,2022,167,1.763,1.629,0.135
,,,0,0.000,0.000,0.000
5,1838,1481,357,1.481,1.193,0.288
5,2227,1809,418,1.794,1.457,0.337
5,1928,1931,-3,1.553,1.556,-0.002
5,1907,2265,-358,1.536,1.825,-0.288
5,1521,2190,-669,1.225,1.764,-0.539
,,,0,0.000,0.000,0.000
5,1673,2339,-666,1.348,1.884,-0.537
,,,0,0.000,0.000,0.000
,,,0,0.000,0.000,0.000
,,,0,0.000,0.000,0.000
,,,0,0.000,0.000,0.000
5,1889,1901,-12,1.522,1.531,-0.010
5,2163,2206,-43,1.742,1.777,-0.035
5,2331,2209,122,1.878,1.780,0.098
,,,0,0.000,0.000,0.000
,,,0,0.000,0.000,0.000
,,,0,0.000,0.000,0.000
5,1836,2230,-394,1.479,1.796,-0.317
5,1835,1970,-135,1.478,1.587,-0.109
5,2061,1942,119,1.660,1.564,0.096
5,1988,2014,-26,1.602,1.622,-0.021
5,2073,1856,217,1.670,1.495,0.175
5,2170,1896,274,1.748,1.527,0.221
5,1900,2192,-292,1.531,1.766,-0.235
,,,0,0.000,0.000,0.000
5,2402,1762,640,1.935,1.419,0.516
,,,0,0.000,0.000,0.000
5,2100,2062,38,1.692,1.661,0.031
5,2279,1737,542,1.836,1.399,0.437
5,1883,1599,284,1.517,1.288,0.229
,,,0,0.000,0.000,0.000
5,1831,1509,322,1.475,1.216,0.259
5,2388,1700,688,1.924,1.369,0.554
5,1944,2186,-242,1.566,1.761,-0.195
5,2350,1875,475,1.893,1.510,0.383
,,,0,0.000,0.000,0.000
5,2025,1994,31,1.631,1.606,0.025
5,2114,2252,-138,1.703,1.814,-0.111
5,1741,1628,113,1.403,1.311,0.091
,,,0,0.000,0.000,0.000
5,1919,2008,-89,1.546,1.618,-0.072
5,1715,2000,-285,1.382,1.611,-0.230
5,1963,2144,-181,1.581,1.727,-0.146
5,2420,1930,490,1.950,1.555,0.395
,,,0,0.000,0.000,0.000
,,,0,0.000,0.000,0.000
,,,0,0.000,0.000,0.000
,,,0,0.000,0.000,0.000
5,1793,1974,-181,1.444,1.590,-0.146
5,1983,2322,-339,1.597,1.871,-0.273
5,1714,1956,-242,1.381,1.576,-0.195
,,,0,0.000,0.000,0.000
5,2030,1750,280,1.635,1.410,0.226
5,2427,2356,71,1.955,1.898,0.057
5,1917,1745,172,1.544,1.406,0.139
,,,0,0.000,0.000,0.000
5,2112,1931,181,1.701,1.556,0.146
5,1893,1560,333,1.525,1.257,0.268
5,2124,1492,632,1.711,1.202,0.509
5,1600,1692,-92,1.289,1.363,-0.074
5,1903,1836,67,1.533,1.479,0.054
5,1837,2066,-229,1.480,1.664,-0.184
5,1817,1860,-43,1.464,1.498,-0.035
5,1645,1681,-36,1.325,1.354,-0.029
5,1901,2095,-194,1.531,1.688,-0.156
5,2327,1500,827,1.875,1.208,0.666
5,2091,1689,402,1.684,1.361,0.324
5,2027,2126,-99,1.633,1.713,-0.080
5,1799,1633,166,1.449,1.316,0.134
5,1563,2283,-720,1.259,1.839,-0.580
,,,0,0.000,0.000,0.000
,,,0,0.000,0.000,0.000
5,1706,1782,-76,1.374,1.436,-0.061
5,1755,1712,43,1.414,1.379,0.035
5,2096,1482,614,1.689,1.194,0.495
5,1773,2178,-405,1.428,1.755,-0.326
5,1849,2043,-194,1.490,1.646,-0.156
,,,0,0.000,0.000,0.000
5,2330,1774,556,1.877,1.429,0.448
5,1807,1815,-8,1.456,1.462,-0.006
5,2100,1930,170,1.692,1.555,0.137
5,1800,1941,-141,1.450,1.564,-0.114
,,,0,0.000,0.000,0.000
,,,0,0.000,0.000,0.000
,,,0,0.000,0.000,0.000
,,,0,0.000,0.000,0.000
5,1999,2044,-45,1.610,1.647,-0.036
5,1811,1709,102,1.459,1.377,0.082
,,,0,0.000,0.000,0.000
5,2200,1682,518,1.772,1.355,0.417
5,1705,1646,59,1.374,1.326,0.048
5,1768,1510,258,1.424,1.216,0.208
,,,0,0.000,0.000,0.000
,,,0,0.000,0.000,0.000
5,1722,2184,-462,1.387,1.759,-0.372
,,,0,0.000,0.000,0.000
5,1640,1906,-266,1.321,1.535,-0.214
5,2030,1567,463,1.635,1.262,0.373
5,1837,2089,-252,1.480,1.683,-0.203
5,2018,2016,2,1.626,1.624,0.002
,,,0,0.000,0.000,0.000
,,,0,0.000,0.000,0.000
5,1694,1643,51,1.365,1.324,0.041
5,2075,1720,355,1.672,1.386,0.286
,,,0,0.000,0.000,0.000
,,,0,0.000,0.000,0.000
,,,0,0.000,0.000,0.000
,,,0,0.000,0.000,0.000
5,1749,1946,-197,1.409,1.568,-0.159
5,1862,2260,-398,1.500,1.821,-0.321
,,,0,0.000,0.000,0.000
,,,0,0.000,0.000,0.000
5,2200,1676,524,1.772,1.350,0.422
,,,0,0.000,0.000,0.000
5,2146,1722,424,1.729,1.387,0.342
5,2160,2048,112,1.740,1.650,0.090
,,,0,0.000,0.000,0.000
,,,0,0.000,0.000,0.000
5,1735,1573,162,1.398,1.267,0.131
5,1939,2085,-146,1.562,1.680,-0.118
5,2119,1995,124,1.707,1.607,0.100
,,,0,0.000,0.000,0.000
5,2086,2072,14,1.680,1.669,0.011
,,,0,0.000,0.000,0.000
5,2038,2024,14,1.642,1.631,0.011
,,,0,0.000,0.000,0.000
,,,0,0.000,0.000,0.000
,,,0,0.000,0.000,0.000
5,1943,1640,303,1.565,1.321,0.244
,,,0,0.000,0.000,0.000
,,,0,0.000,0.000,0.000
5,2144,1667,477,1.727,1.343,0.384
,,,0,0.000,0.000,0.000
,,,0,0.000,0.000,0.000
,,,0,0.000,0.000,0.000
,,,0,0.000,0.000,0.000
5,1932,1881,51,1.556,1.515,0.041
5,2032,1714,318,1.637,1.381,0.256
5,2068,2144,-76,1.666,1.727,-0.061
5,1639,1895,-256,1.320,1.527,-0.206
5,2365,1836,529,1.905,1.479,0.426
5,1520,1920,-400,1.224,1.547,-0.322
5,2346,1501,845,1.890,1.209,0.681
,,,0,0.000,0.000,0.000
5,2379,1848,531,1.916,1.489,0.428
,,,0,0.000,0.000,0.000
,,,0,0.000,0.000,0.000
5,1753,1595,158,1.412,1.285,0.127
5,2379,1905,474,1.916,1.535,0.382
5,2324,2296,28,1.872,1.850,0.023
,,,0,0.000,0.000,0.000
,,,0,0.000,0.000,0.000
5,2220,1802,418,1.788,1.452,0.337
,,,0,0.000,0.000,0.000
5,1730,1924,-194,1.394,1.550,-0.156
,,,0,0.000,0.000,0.000
,,,0,0.000,0.000,0.000
5,2218,1457,761,1.787,1.174,0.613
5,1795,1745,50,1.446,1.406,0.040
,,,0,0.000,0.000,0.000
,,,0,0.000,0.000,0.000
5,1903,2202,-299,1.533,1.774,-0.241
5,1663,1458,205,1.340,1.175,0.165
5,1887,2190,-303,1.520,1.764,-0.244
,,,0,0.000,0.000,0.000
5,1556,2323,-767,1.253,1.871,-0.618
5,1735,1802,-67,1.398,1.452,-0.054
5,2020,2269,-249,1.627,1.828,-0.201
5,1610,1762,-152,1.297,1.419,-0.122
,,,0,0.000,0.000,0.000
5,2368,2301,67,1.908,1.854,0.054
,,,0,0.000,0.000,0.000
,,,0,0.000,0.000,0.000
5,2219,2040,179,1.788,1.643,0.144
5,2210,2043,167,1.780,1.646,0.135
,,,0,0.000,0.000,0.000
5,2128,2213,-85,1.714,1.783,-0.068
5,1913,2165,-252,1.541,1.744,-0.203
5,2180,1919,261,1.756,1.546,0.210
,,,0,0.000,0.000,0.000
,,,0,0.000,0.000,0.000
,,,0,0.000,0.000,0.000
,,,0,0.000,0.000,0.000
,,,0,0.000,0.000,0.000
,,,0,0.000,0.000,0.000
,,,0,0.000,0.000,0.000
5,1721,2064,-343,1.386,1.663,-0.276
5,1920,1663,257,1.547,1.340,0.207
5,2041,2232,-191,1.644,1.798,-0.154
5,1838,2382,-544,1.481,1.919,-0.438
5,1767,2376,-609,1.423,1.914,-0.491
5,1845,2147,-302,1.486,1.730,-0.243
,,,0,0.000,0.000,0.000
5,2282,2053,229,1.838,1.654,0.184
5,1811,1547,264,1.459,1.246,0.213
5,2334,1491,843,1.880,1.201,0.679
5,1809,1946,-137,1.457,1.568,-0.110
5,1909,1740,169,1.538,1.402,0.136
5,1805,1915,-110,1.454,1.543,-0.089
5,2237,1469,768,1.802,1.183,0.619
5,1700,1603,97,1.369,1.291,0.078
,,,0,0.000,0.000,0.000
,,,0,0.000,0.000,0.000
5,2050,1780,270,1.651,1.434,0.218
5,2262,2184,78,1.822,1.759,0.063
5,1791,1734,57,1.443,1.397,0.046
5,2050,1629,421,1.651,1.312,0.339
5,2100,1724,376,1.692,1.389,0.303
5,1917,2104,-187,1.544,1.695,-0.151
5,2181,2044,137,1.757,1.647,0.110
5,2210,2027,183,1.780,1.633,0.147
5,2029,1654,375,1.635,1.332,0.302
5,1754,2097,-343,1.413,1.689,-0.276
5,2068,2155,-87,1.666,1.736,-0.070
5,2176,1698,478,1.753,1.368,0.385
5,1593,1744,-151,1.283,1.405,-0.122
5,1849,1746,103,1.490,1.407,0.083
,,,0,0.000,0.000,0.000
,,,0,0.000,0.000,0.000
,,,0,0.000,0.000,0.000
5,1861,2148,-287,1.499,1.730,-0.231
5,1803,1648,155,1.452,1.328,0.125
5,2066,1899,167,1.664,1.530,0.135
,,,0,0.000,0.000,0.000
5,2176,2108,68,1.753,1.698,0.055
5,2116,1935,181,1.705,1.559,0.146
5,1939,1954,-15,1.562,1.574,-0.012
5,1560,1971,-411,1.257,1.588,-0.331
5,1486,1949,-463,1.197,1.570,-0.373
,,,0,0.000,0.000,0.000
5,1526,1779,-253,1.229,1.433,-0.204
5,1896,1927,-31,1.527,1.552,-0.025
5,2420,1567,853,1.950,1.262,0.687
,,,0,0.000,0.000,0.000
,,,0,0.000,0.000,0.000
5,1925,1612,313,1.551,1.299,0.252
,,,0,0.000,0.000,0.000
,,,0,0.000,0.000,0.000
5,1942,1629,313,1.564,1.312,0.252
5,2204,2384,-180,1.776,1.921,-0.145
5,2133,2018,115,1.718,1.626,0.093
5,1847,2144,-297,1.488,1.727,-0.239
5,1762,2069,-307,1.419,1.667,-0.247
5,1775,2196,-421,1.430,1.769,-0.339
5,2241,1781,460,1.805,1.435,0.371
,,,0,0.000,0.000,0.000
5,1696,2045,-349,1.366,1.647,-0.281
5,1707,1755,-48,1.375,1.414,-0.039
5,2183,1811,372,1.759,1.459,0.300
5,1496,2049,-553,1.205,1.651,-0.445
5,1861,2196,-335,1.499,1.769,-0.270
,,,0,0.000,0.000,0.000
5,1576,1922,-346,1.270,1.548,-0.279
,,,0,0.000,0.000,0.000
5,1702,2101,-399,1.371,1.693,-0.321
5,2075,1924,151,1.672,1.550,0.122
,,,0,0.000,0.000,0.000
,,,0,0.000,0.000,0.000
5,1908,1483,425,1.537,1.195,0.342
5,2221,1855,366,1.789,1.494,0.295
,,,0,0.000,0.000,0.000
5,2036,1895,141,1.640,1.527,0.114
5,1660,1778,-118,1.337,1.432,-0.095
5,2370,2158,212,1.909,1.738,0.171
5,2100,1751,349,1.692,1.411,0.281
5,1867,1771,96,1.504,1.427,0.077
,,,0,0.000,0.000,0.000
,,,0,0.000,0.000,0.000
,,,0,0.000,0.000,0.000
5,2138,1876,262,1.722,1.511,0.211
5,2192,2077,115,1.766,1.673,0.093
,,,0,0.000,0.000,0.000
5,1907,1489,418,1.536,1.200,0.337
5,2127,1853,274,1.713,1.493,0.221
5,1600,2309,-709,1.289,1.860,-0.571
5,2220,1935,285,1.788,1.559,0.230
5,2264,2180,84,1.824,1.756,0.068
,,,0,0.000,0.000,0.000
5,1617,1711,-94,1.303,1.378,-0.076
,,,0,0.000,0.000,0.000
5,2160,1678,482,1.740,1.352,0.388
5,1625,1820,-195,1.309,1.466,-0.157
5,1976,2006,-30,1.592,1.616,-0.024
5,2120,2099,21,1.708,1.691,0.017
,,,0,0.000,0.000,0.000
5,1637,2091,-454,1.319,1.684,-0.366
5,1855,1699,156,1.494,1.369,0.126
5,2077,2322,-245,1.673,1.871,-0.197
5,1893,2157,-264,1.525,1.738,-0.213
5,1619,1885,-266,1.304,1.519,-0.214
5,2166,2112,54,1.745,1.701,0.044
,,,0,0.000,0.000,0.000
,,,0,0.000,0.000,0.000
5,2338,2182,156,1.883,1.758,0.126
5,1637,1696,-59,1.319,1.366,-0.048
5,1773,2133,-360,1.428,1.718,-0.290
,,,0,0.000,0.000,0.000
,,,0,0.000,0.000,0.000
,,,0,0.000,0.000,0.000
,,,0,0.000,0.000,0.000
5,2158,2035,123,1.738,1.639,0.099
,,,0,0.000,0.000,0.000
5,1815,2219,-404,1.462,1.788,-0.325
5,1711,1877,-166,1.378,1.512,-0.134
,,,0,0.000,0.000,0.000
5,1700,2202,-502,1.369,1.774,-0.404
5,2219,1841,378,1.788,1.483,0.305
,,,0,0.000,0.000,0.000
5,2405,1681,724,1.937,1.354,0.583
5,1807,1773,34,1.456,1.428,0.027
,,,0,0.000,0.000,0.000
5,2294,1928,366,1.848,1.553,0.295
5,1501,1920,-419,1.209,1.547,-0.338
5,1847,2326,-479,1.488,1.874,-0.386
5,1785,1850,-65,1.438,1.490,-0.052
,,,0,0.000,0.000,0.000
,,,0,0.000,0.000,0.000
5,1582,1638,-56,1.274,1.320,-0.045
,,,0,0.000,0.000,0.000
5,2406,1785,621,1.938,1.438,0.500
,,,0,0.000,0.000,0.000
5,2185,1660,525,1.760,1.337,0.423
5,2150,2393,-243,1.732,1.928,-0.196
5,1942,1930,12,1.564,1.555,0.010
,,,0,0.000,0.000,0.000
5,1823,1871,-48,1.469,1.507,-0.039
5,2088,2388,-300,1.682,1.924,-0.242
,,,0,0.000,0.000,0.000
5,1771,1952,-181,1.427,1.573,-0.146
5,2112,1585,527,1.701,1.277,0.425
,,,0,0.000,0.000,0.000
,,,0,0.000,0.000,0.000
5,1825,1878,-53,1.470,1.513,-0.043
5,1739,1578,161,1.401,1.271,0.130
5,2310,2199,111,1.861,1.771,0.089
5,2228,2320,-92,1.795,1.869,-0.074
,,,0,0.000,0.000,0.000
,,,0,0.000,0.000,0.000
,,,0,0.000,0.000,0.000
,,,0,0.000,0.000,0.000
5,1878,1671,207,1.513,1.346,0.167
,,,0,0.000,0.000,0.000
5,1889,2064,-175,1.522,1.663,-0.141
5,2082,1865,217,1.677,1.502,0.175
5,2392,2058,334,1.927,1.658,0.269
5,2018,1592,426,1.626,1.282,0.343
5,2012,1864,148,1.621,1.502,0.119
5,1879,1671,208,1.514,1.346,0.168
,,,0,0.000,0.000,0.000
5,2137,1821,316,1.722,1.467,0.255
5,1720,1914,-194,1.386,1.542,-0.156
5,1983,2025,-42,1.597,1.631,-0.034
,,,0,0.000,0.000,0.000
,,,0,0.000,0.000,0.000
5,1558,1749,-191,1.255,1.409,-0.154
5,1751,1539,212,1.411,1.240,0.171
,,,0,0.000,0.000,0.000
,,,0,0.000,0.000,0.000
5,2248,1510,738,1.811,1.216,0.595
5,2202,1935,267,1.774,1.559,0.215
,,,0,0.000,0.000,0.000
5,2096,2028,68,1.689,1.634,0.055
,,,0,0.000,0.000,0.000
5,1946,2111,-165,1.568,1.701,-0.133
,,,0,0.000,0.000,0.000
,,,0,0.000,0.000,0.000
,,,0,0.000,0.000,0.000
5,2196,1967,229,1.769,1.585,0.184
,,,0,0.000,0.000,0.000
,,,0,0.000,0.000,0.000
5,2081,1729,352,1.676,1.393,0.284
5,2375,2150,225,1.913,1.732,0.181
5,1815,1766,49,1.462,1.423,0.039
5,1728,1887,-159,1.392,1.520,-0.128
5,1527,2178,-651,1.230,1.755,-0.524
,,,0,0.000,0.000,0.000
,,,0,0.000,0.000,0.000
5,1711,2154,-443,1.378,1.735,-0.357
,,,0,0.000,0.000,0.000
,,,0,0.000,0.000,0.000
,,,0,0.000,0.000,0.000
5,1953,1653,300,1.573,1.332,0.242
5,1622,2081,-459,1.307,1.676,-0.370
5,2258,1838,420,1.819,1.481,0.338
5,1573,2387,-814,1.267,1.923,-0.656
5,1574,2022,-448,1.268,1.629,-0.361
5,1887,1826,61,1.520,1.471,0.049
5,1574,1825,-251,1.268,1.470,-0.202
,,,0,0.000,0.000,0.000
5,2118,2151,-33,1.706,1.733,-0.027
5,2195,2176,19,1.768,1.753,0.015
5,1823,2119,-296,1.469,1.707,-0.238
5,1720,1868,-148,1.386,1.505,-0.119
5,1823,1860,-37,1.469,1.498,-0.030
,,,0,0.000,0.000,0.000
5,1867,1812,55,1.504,1.460,0.044
5,1973,1858,115,1.589,1.497,0.093
5,1705,1538,167,1.374,1.239,0.135
,,,0,0.000,0.000,0.000
5,1727,2068,-341,1.391,1.666,-0.275
5,1881,2322,-441,1.515,1.871,-0.355
5,1914,1711,203,1.542,1.378,0.164
5,2234,1997,237,1.800,1.609,0.191
5,1649,1483,166,1.328,1.195,0.134
5,1966,1915,51,1.584,1.543,0.041
5,2232,2107,125,1.798,1.697,0.101
,,,0,0.000,0.000,0.000
5,1493,1492,1,1.203,1.202,0.001
,,,0,0.000,0.000,0.000
5,1960,1862,98,1.579,1.500,0.079
5,1768,1658,110,1.424,1.336,0.089
,,,0,0.000,0.000,0.000
5,1864,1810,54,1.502,1.458,0.044
5,1711,2054,-343,1.378,1.655,-0.276
,,,0,0.000,0.000,0.000
,,,0,0.000,0.000,0.000
,,,0,0.000,0.000,0.000
,,,0,0.000,0.000,0.000
5,1581,1887,-306,1.274,1.520,-0.247
5,2248,1675,573,1.811,1.349,0.462
5,1794,1927,-133,1.445,1.552,-0.107
5,1485,2134,-649,1.196,1.719,-0.523
,,,0,0.000,0.000,0.000
5,2113,2102,11,1.702,1.693,0.009
,,,0,0.000,0.000,0.000
,,,0,0.000,0.000,0.000
5,1728,1626,102,1.392,1.310,0.082
5,2412,1679,733,1.943,1.353,0.590
5,1590,1581,9,1.281,1.274,0.007
5,2261,1573,688,1.821,1.267,0.554
5,1890,1965,-75,1.523,1.583,-0.060
5,1825,1659,166,1.470,1.336,0.134
5,2036,1963,73,1.640,1.581,0.059
,,,0,0.000,0.000,0.000
5,2098,2130,-32,1.690,1.716,-0.026
5,2198,1776,422,1.771,1.431,0.340
5,1789,1780,9,1.441,1.434,0.007
,,,0,0.000,0.000,0.000
5,1692,1794,-102,1.363,1.445,-0.082
5,1699,1744,-45,1.369,1.405,-0.036
5,2173,1907,266,1.751,1.536,0.214
5,1606,2154,-548,1.294,1.735,-0.441
5,1962,2295,-333,1.581,1.849,-0.268
5,1843,2124,-281,1.485,1.711,-0.226
5,2237,2005,232,1.802,1.615,0.187
5,2386,1752,634,1.922,1.411,0.511
5,1647,1691,-44,1.327,1.362,-0.035
5,1586,2188,-602,1.278,1.763,-0.485
5,2103,1882,221,1.694,1.516,0.178
5,2084,1915,169,1.679,1.543,0.136
,,,0,0.000,0.000,0.000
5,1550,1470,80,1.249,1.184,0.064
5,1789,2176,-387,1.441,1.753,-0.312
5,1984,2126,-142,1.598,1.713,-0.114
5,1914,1957,-43,1.542,1.577,-0.035
5,1980,1668,312,1.595,1.344,0.251
5,2130,1654,476,1.716,1.332,0.383
5,2018,2200,-182,1.626,1.772,-0.147
5,2168,1898,270,1.747,1.529,0.218
,,,0,0.000,0.000,0.000
5,1581,2190,-609,1.274,1.764,-0.491
5,1530,1895,-365,1.233,1.527,-0.294
,,,0,0.000,0.000,0.000
,,,0,0.000,0.000,0.000
,,,0,0.000,0.000,0.000
,,,0,0.000,0.000,0.000
,,,0,0.000,0.000,0.000
5,1889,1984,-95,1.522,1.598,-0.077
5,2070,1960,110,1.668,1.579,0.089
5,1837,1744,93,1.480,1.405,0.075
5,1971,2122,-151,1.588,1.709,-0.122
5,1896,1739,157,1.527,1.401,0.126
5,2179,2218,-39,1.755,1.787,-0.031
5,2249,1894,355,1.812,1.526,0.286
,,,0,0.000,0.000,0.000
,,,0,0.000,0.000,0.000
5,1752,1809,-57,1.411,1.457,-0.046
5,1783,2235,-452,1.436,1.800,-0.364
5,2364,2040,324,1.904,1.643,0.261
,,,0,0.000,0.000,0.000
5,2037,1779,258,1.641,1.433,0.208
5,1793,2148,-355,1.444,1.730,-0.286
,,,0,0.000,0.000,0.000
,,,0,0.000,0.000,0.000
5,2284,2160,124,1.840,1.740,0.100
5,2385,1498,887,1.921,1.207,0.715
,,,0,0.000,0.000,0.000
5,2132,2283,-151,1.718,1.839,-0.122
5,2099,1467,632,1.691,1.182,0.509
5,2196,2121,75,1.769,1.709,0.060
5,2083,1874,209,1.678,1.510,0.168
5,2136,1694,442,1.721,1.365,0.356
5,2172,2147,25,1.750,1.730,0.020
5,1654,1938,-284,1.332,1.561,-0.229
5,1691,2235,-544,1.362,1.800,-0.438
5,2146,2173,-27,1.729,1.751,-0.022
5,1921,2334,-413,1.548,1.880,-0.333
5,2086,1499,587,1.680,1.208,0.473
5,2073,1710,363,1.670,1.378,0.292
5,1820,2213,-393,1.466,1.783,-0.317
5,2128,2214,-86,1.714,1.784,-0.069
5,1649,1790,-141,1.328,1.442,-0.114
5,2059,1838,221,1.659,1.481,0.178
5,1588,2143,-555,1.279,1.726,-0.447
5,1642,1681,-39,1.323,1.354,-0.031
5,2092,1839,253,1.685,1.481,0.204
5,1579,1935,-356,1.272,1.559,-0.287
5,1728,2277,-549,1.392,1.834,-0.442
5,1774,2283,-509,1.429,1.839,-0.410
5,2130,1604,526,1.716,1.292,0.424
5,2079,1762,317,1.675,1.419,0.255
5,2230,1493,737,1.796,1.203,0.594
5,1919,2359,-440,1.546,1.900,-0.354
5,2176,2156,20,1.753,1.737,0.016
5,1490,1928,-438,1.200,1.553,-0.353
5,1796,1526,270,1.447,1.229,0.218
5,1531,2025,-494,1.233,1.631,-0.398
5,1841,1727,114,1.483,1.391,0.092
5,1886,2116,-230,1.519,1.705,-0.185
5,1719,2201,-482,1.385,1.773,-0.388
5,2057,1742,315,1.657,1.403,0.254
5,1944,2147,-203,1.566,1.730,-0.164
5,2052,1831,221,1.653,1.475,0.178
5,2091,2012,79,1.684,1.621,0.064
5,1600,1479,121,1.289,1.191,0.097
5,2055,1928,127,1.655,1.553,0.102
5,2146,1761,385,1.729,1.419,0.310
5,1502,1591,-89,1.210,1.282,-0.072
5,1909,1994,-85,1.538,1.606,-0.068
5,1591,1523,68,1.282,1.227,0.055
5,1922,1607,315,1.548,1.295,0.254
5,2009,2137,-128,1.618,1.722,-0.103
5,2150,1674,476,1.732,1.349,0.383
5,2201,2232,-31,1.773,1.798,-0.025
5,1990,1663,327,1.603,1.340,0.263
5,1669,2109,-440,1.345,1.699,-0.354
5,2021,2211,-190,1.628,1.781,-0.153
5,1717,2056,-339,1.383,1.656,-0.273
5,1492,1988,-496,1.202,1.602,-0.400
5,1805,1847,-42,1.454,1.488,-0.034
5,2158,2144,14,1.738,1.727,0.011
5,1751,2042,-291,1.411,1.645,-0.234
5,1951,1749,202,1.572,1.409,0.163
5,1747,1835,-88,1.407,1.478,-0.071
5,1574,2179,-605,1.268,1.755,-0.487
5,1775,2116,-341,1.430,1.705,-0.275
5,1660,2051,-391,1.337,1.652,-0.315
,,,0,0.000,0.000,0.000
5,1775,1716,59,1.430,1.382,0.048
5,2082,1759,323,1.677,1.417,0.260
5,2002,2185,-183,1.613,1.760,-0.147
5,2243,2009,234,1.807,1.618,0.189
5,1491,1674,-183,1.201,1.349,-0.147
5,2201,1565,636,1.773,1.261,0.512
5,1730,2222,-492,1.394,1.790,-0.396
5,1612,2214,-602,1.299,1.784,-0.485
5,1801,2393,-592,1.451,1.928,-0.477
5,2354,2129,225,1.896,1.715,0.181
5,1894,2128,-234,1.526,1.714,-0.189
5,2096,1622,474,1.689,1.307,0.382
5,2146,1622,524,1.729,1.307,0.422
5,1505,2204,-699,1.212,1.776,-0.563
5,1551,1751,-200,1.249,1.411,-0.161
5,2058,2134,-76,1.658,1.719,-0.061
5,1891,1515,376,1.523,1.220,0.303
5,1767,2165,-398,1.423,1.744,-0.321
5,2382,1505,877,1.919,1.212,0.706
5,2079,2048,31,1.675,1.650,0.025
5,2116,1838,278,1.705,1.481,0.224
5,2199,2072,127,1.771,1.669,0.102
5,1831,2117,-286,1.475,1.705,-0.230
5,2173,1533,640,1.751,1.235,0.516
5,2212,2340,-128,1.782,1.885,-0.103
5,1587,1468,119,1.278,1.183,0.096
5,2044,1462,582,1.647,1.178,0.469
5,1783,1972,-189,1.436,1.589,-0.152
5,2084,1498,586,1.679,1.207,0.472
5,2019,1539,480,1.626,1.240,0.387
5,1751,2187,-436,1.411,1.762,-0.351
5,1991,1822,169,1.604,1.468,0.136
5,1659,1645,14,1.336,1.325,0.011
5,2228,1649,579,1.795,1.328,0.466
5,2233,2010,223,1.799,1.619,0.180
5,1772,1924,-152,1.427,1.550,-0.122
5,1722,1861,-139,1.387,1.499,-0.112
5,2276,2258,18,1.834,1.819,0.015
5,2117,1740,377,1.705,1.402,0.304
5,2109,2301,-192,1.699,1.854,-0.155
5,1845,1466,379,1.486,1.181,0.305
5,1879,1816,63,1.514,1.463,0.051
5,1551,1900,-349,1.249,1.531,-0.281
5,1587,2288,-701,1.278,1.843,-0.565
5,1990,2183,-193,1.603,1.759,-0.155
5,1695,1984,-289,1.365,1.598,-0.233
5,1944,2040,-96,1.566,1.643,-0.077
5,2428,1751,677,1.956,1.411,0.545
5,2269,2359,-90,1.828,1.900,-0.073
5,1704,1952,-248,1.373,1.573,-0.200
5,1508,1715,-207,1.215,1.382,-0.167
5,2091,2280,-189,1.684,1.837,-0.152
5,1838,1575,263,1.481,1.269,0.212
5,2218,1862,356,1.787,1.500,0.287
5,2036,2231,-195,1.640,1.797,-0.157
5,2251,2088,163,1.813,1.682,0.131
5,2162,1751,411,1.742,1.411,0.331
5,1917,2056,-139,1.544,1.656,-0.112
5,1604,1598,6,1.292,1.287,0.005
5,2040,2076,-36,1.643,1.672,-0.029
5,2402,2328,74,1.935,1.875,0.060
5,2286,1867,419,1.842,1.504,0.338
5,1516,1715,-199,1.221,1.382,-0.160
5,2080,2013,67,1.676,1.622,0.054
5,1831,1515,316,1.475,1.220,0.255
5,2144,1778,366,1.727,1.432,0.295
5,1899,1837,62,1.530,1.480,0.050
5,1733,1977,-244,1.396,1.593,-0.197
5,2352,1937,415,1.895,1.560,0.334
5,2141,2121,20,1.725,1.709,0.016
5,2037,1933,104,1.641,1.557,0.084
5,1783,1885,-102,1.436,1.519,-0.082
5,1686,1731,-45,1.358,1.394,-0.036
5,1987,1621,366,1.601,1.306,0.295
5,2040,1720,320,1.643,1.386,0.258
5,2348,1559,789,1.892,1.256,0.636
5,1984,1767,217,1.598,1.423,0.175
5,1985,1675,310,1.599,1.349,0.250
5,1585,2290,-705,1.277,1.845,-0.568
5,2250,2020,230,1.813,1.627,0.185
5,1665,1948,-283,1.341,1.569,-0.228
5,2122,1639,483,1.709,1.320,0.389
5,2218,1481,737,1.787,1.193,0.594
5,1847,2183,-336,1.488,1.759,-0.271
5,1891,2070,-179,1.523,1.668,-0.144
5,1715,2008,-293,1.382,1.618,-0.236
5,1504,2368,-864,1.212,1.908,-0.696
5,2230,2211,19,1.796,1.781,0.015
5,1702,1804,-102,1.371,1.453,-0.082
5,1861,1749,112,1.499,1.409,0.090
5,2104,1723,381,1.695,1.388,0.307
5,1735,1927,-192,1.398,1.552,-0.155
5,1731,1936,-205,1.394,1.560,-0.165
5,1518,2072,-554,1.223,1.669,-0.446
5,1734,1791,-57,1.397,1.443,-0.046
5,1900,2034,-134,1.531,1.639,-0.108
5,1894,1735,159,1.526,1.398,0.128
5,2256,1928,328,1.817,1.553,0.264
5,1567,2269,-702,1.262,1.828,-0.566
5,2186,1714,472,1.761,1.381,0.380
5,1717,1605,112,1.383,1.293,0.090
5,1912,1873,39,1.540,1.509,0.031
5,1767,1917,-150,1.423,1.544,-0.121
5,2078,1661,417,1.674,1.338,0.336
5,2232,1651,581,1.798,1.330,0.468
5,2232,1558,674,1.798,1.255,0.543
5,1667,1664,3,1.343,1.340,0.002
5,2245,1970,275,1.809,1.587,0.222
5,1782,2129,-347,1.436,1.715,-0.280
5,2201,2129,72,1.773,1.715,0.058
5,1926,2132,-206,1.552,1.718,-0.166
5,1890,1731,159,1.523,1.394,0.128
5,2200,2178,22,1.772,1.755,0.018
5,2144,1976,168,1.727,1.592,0.135
5,1888,2176,-288,1.521,1.753,-0.232
5,1574,1880,-306,1.268,1.515,-0.247
5,1785,1622,163,1.438,1.307,0.131
5,1779,2011,-232,1.433,1.620,-0.187
5,1878,2060,-182,1.513,1.660,-0.147
5,2130,2372,-242,1.716,1.911,-0.195
5,2188,1814,374,1.763,1.461,0.301
5,2176,1493,683,1.753,1.203,0.550
5,2272,1745,527,1.830,1.406,0.425
5,1909,2191,-282,1.538,1.765,-0.227
5,2002,2039,-37,1.613,1.643,-0.030
5,2156,2194,-38,1.737,1.767,-0.031
5,1491,1944,-453,1.201,1.566,-0.365
5,1595,1900,-305,1.285,1.531,-0.246
5,2060,2098,-38,1.660,1.690,-0.031
5,1751,1987,-236,1.411,1.601,-0.190
5,2265,1791,474,1.825,1.443,0.382
5,1905,1847,58,1.535,1.488,0.047
5,2266,1686,580,1.825,1.358,0.467
5,1917,1858,59,1.544,1.497,0.048
5,2440,1452,988,1.966,1.170,0.796
5,2342,1864,478,1.887,1.502,0.385
5,1871,1919,-48,1.507,1.546,-0.039
5,1773,1879,-106,1.428,1.514,-0.085
5,1795,1852,-57,1.446,1.492,-0.046
5,1965,1910,55,1.583,1.539,0.044
5,1715,1713,2,1.382,1.380,0.002
5,1881,1783,98,1.515,1.436,0.079
5,1899,1638,261,1.530,1.320,0.210
5,2168,1662,506,1.747,1.339,0.408
5,1775,1926,-151,1.430,1.552,-0.122
5,1723,2230,-507,1.388,1.796,-0.408
5,2092,2242,-150,1.685,1.806,-0.121
5,1859,1758,101,1.498,1.416,0.081
5,1710,2105,-395,1.378,1.696,-0.318
5,1721,1970,-249,1.386,1.587,-0.201
5,1580,2142,-562,1.273,1.726,-0.453
5,1864,1813,51,1.502,1.461,0.041
5,1769,1873,-104,1.425,1.509,-0.084
5,1918,1965,-47,1.545,1.583,-0.038
5,1626,1726,-100,1.310,1.390,-0.081
5,1929,1990,-61,1.554,1.603,-0.049
,,,0,0.000,0.000,0.000
5,1913,2160,-247,1.541,1.740,-0.199
5,2184,1926,258,1.759,1.552,0.208
5,2194,1874,320,1.767,1.510,0.258
5,1975,1867,108,1.591,1.504,0.087
5,1570,2382,-812,1.265,1.919,-0.654
5,2345,1670,675,1.889,1.345,0.544
5,1728,2134,-406,1.392,1.719,-0.327
5,2423,1742,681,1.952,1.403,0.549
5,2222,1790,432,1.790,1.442,0.348
5,2114,2250,-136,1.703,1.813,-0.110
5,1813,2003,-190,1.461,1.614,-0.153
5,2075,1769,306,1.672,1.425,0.247
5,2236,2113,123,1.801,1.702,0.099
5,2182,1596,586,1.758,1.286,0.472
5,2436,2308,128,1.962,1.859,0.103
5,2225,2048,177,1.792,1.650,0.143
5,1600,1593,7,1.289,1.283,0.006
5,1707,2313,-606,1.375,1.863,-0.488
5,1871,2168,-297,1.507,1.747,-0.239
5,1513,1667,-154,1.219,1.343,-0.124
5,1887,1717,170,1.520,1.383,0.137
5,2138,1823,315,1.722,1.469,0.254
5,2200,1772,428,1.772,1.427,0.345
5,1828,1963,-135,1.473,1.581,-0.109
5,2186,2384,-198,1.761,1.921,-0.160
5,1924,1890,34,1.550,1.523,0.027
5,1784,1583,201,1.437,1.275,0.162
5,1542,2108,-566,1.242,1.698,-0.456
5,2134,2124,10,1.719,1.711,0.008
5,1578,1978,-400,1.271,1.593,-0.322
5,2260,1530,730,1.821,1.233,0.588
5,2101,2089,12,1.693,1.683,0.010
5,2008,1742,266,1.618,1.403,0.214
5,2059,1907,152,1.659,1.536,0.122
5,2230,2163,67,1.796,1.742,0.054
5,1659,1808,-149,1.336,1.456,-0.120
5,2270,1748,522,1.829,1.408,0.421
5,2182,2327,-145,1.758,1.875,-0.117
5,2192,1823,369,1.766,1.469,0.297
5,2246,1566,680,1.809,1.262,0.548
5,1979,1550,429,1.594,1.249,0.346
5,1982,2066,-84,1.597,1.664,-0.068
5,2192,2373,-181,1.766,1.912,-0.146
5,2345,1922,423,1.889,1.548,0.341
5,1773,1829,-56,1.428,1.473,-0.045
5,1844,1845,-1,1.485,1.486,-0.001
5,1915,1961,-46,1.543,1.580,-0.037
5,2036,1778,258,1.640,1.432,0.208
5,1844,1677,167,1.485,1.351,0.135
5,1941,1847,94,1.564,1.488,0.076
5,2321,1987,334,1.870,1.601,0.269
5,1802,1690,112,1.452,1.361,0.090
5,2024,2224,-200,1.631,1.792,-0.161
5,1514,1823,-309,1.220,1.469,-0.249
5,1887,2189,-302,1.520,1.763,-0.243
5,2210,1580,630,1.780,1.273,0.508
5,1588,1845,-257,1.279,1.486,-0.207
5,1485,2304,-819,1.196,1.856,-0.660
5,2120,2201,-81,1.708,1.773,-0.065
5,2076,1935,141,1.672,1.559,0.114
5,1995,1740,255,1.607,1.402,0.205
5,2066,1548,518,1.664,1.247,0.417
5,1876,2166,-290,1.511,1.745,-0.234
5,1834,2234,-400,1.477,1.800,-0.322
5,1690,1791,-101,1.361,1.443,-0.081
5,2005,1950,55,1.615,1.571,0.044
5,2235,1923,312,1.800,1.549,0.251
5,1571,1727,-156,1.266,1.391,-0.126
5,2097,1967,130,1.689,1.585,0.105
5,2142,1727,415,1.726,1.391,0.334
5,1737,1923,-186,1.399,1.549,-0.150
5,1846,1791,55,1.487,1.443,0.044
5,2166,2145,21,1.745,1.728,0.017
5,2171,1646,525,1.749,1.326,0.423
5,1909,1942,-33,1.538,1.564,-0.027
5,2015,2318,-303,1.623,1.867,-0.244
5,1975,1655,320,1.591,1.333,0.258
5,2077,2114,-37,1.673,1.703,-0.030
5,1831,1720,111,1.475,1.386,0.089
5,2152,2151,1,1.734,1.733,0.001
5,2291,1611,680,1.846,1.298,0.548
5,1916,1873,43,1.544,1.509,0.035
5,2082,1923,159,1.677,1.549,0.128
5,1920,2018,-98,1.547,1.626,-0.079
5,1790,1783,7,1.442,1.436,0.006
5,1791,1782,9,1.443,1.436,0.007
,,,0,0.000,0.000,0.000
5,2044,1731,313,1.647,1.394,0.252
5,2110,2143,-33,1.700,1.726,-0.027
5,2215,1686,529,1.784,1.358,0.426
5,2261,2037,224,1.821,1.641,0.180
5,2003,2094,-91,1.614,1.687,-0.073
5,1865,2048,-183,1.502,1.650,-0.147
5,1647,1845,-198,1.327,1.486,-0.160
5,1941,1737,204,1.564,1.399,0.164
5,1942,1741,201,1.564,1.403,0.162
5,2222,1653,569,1.790,1.332,0.458
5,2023,1967,56,1.630,1.585,0.045
5,1575,1972,-397,1.269,1.589,-0.320
5,1626,1922,-296,1.310,1.548,-0.238
5,1903,2246,-343,1.533,1.809,-0.276
5,1637,1837,-200,1.319,1.480,-0.161
5,1985,2019,-34,1.599,1.626,-0.027
5,2250,1823,427,1.813,1.469,0.344
5,2048,2024,24,1.650,1.631,0.019
5,1791,1587,204,1.443,1.278,0.164
5,2322,2145,177,1.871,1.728,0.143
5,2273,2108,165,1.831,1.698,0.133
5,2018,1659,359,1.626,1.336,0.289
5,1563,1707,-144,1.259,1.375,-0.116
5,2191,1831,360,1.765,1.475,0.290
5,2143,1742,401,1.726,1.403,0.323
5,1583,1793,-210,1.275,1.444,-0.169
5,1747,1738,9,1.407,1.400,0.007
5,1697,2240,-543,1.367,1.805,-0.437
5,2154,2238,-84,1.735,1.803,-0.068
5,2147,1724,423,1.730,1.389,0.341
5,1569,2178,-609,1.264,1.755,-0.491
5,1576,1830,-254,1.270,1.474,-0.205
5,1986,2235,-249,1.600,1.800,-0.201
5,1744,2094,-350,1.405,1.687,-0.282
5,1542,1489,53,1.242,1.200,0.043
5,2436,1708,728,1.962,1.376,0.586
5,2082,1607,475,1.677,1.295,0.383
5,2140,1602,538,1.724,1.291,0.433
5,2437,1544,893,1.963,1.244,0.719
5,1757,1997,-240,1.415,1.609,-0.193
5,1910,2140,-230,1.539,1.724,-0.185
5,2120,2055,65,1.708,1.655,0.052
5,1977,1814,163,1.593,1.461,0.131
5,1773,1665,108,1.428,1.341,0.087
5,1774,2066,-292,1.429,1.664,-0.235
5,1717,1816,-99,1.383,1.463,-0.080
5,2088,1562,526,1.682,1.258,0.424
5,2250,2026,224,1.813,1.632,0.180
5,2093,2226,-133,1.686,1.793,-0.107
5,1729,2136,-407,1.393,1.721,-0.328
5,2264,2142,122,1.824,1.726,0.098
5,1758,1853,-95,1.416,1.493,-0.077
5,2335,1708,627,1.881,1.376,0.505
5,2278,1596,682,1.835,1.286,0.549
5,1861,1811,50,1.499,1.459,0.040
5,2071,2370,-299,1.668,1.909,-0.241
5,1764,1995,-231,1.421,1.607,-0.186
5,1861,2051,-190,1.499,1.652,-0.153
5,1498,1790,-292,1.207,1.442,-0.235
5,1638,1884,-246,1.320,1.518,-0.198
5,1837,1774,63,1.480,1.429,0.051
5,1518,2179,-661,1.223,1.755,-0.532
5,2034,2074,-40,1.639,1.671,-0.032
5,2149,1623,526,1.731,1.307,0.424
5,1530,1923,-393,1.233,1.549,-0.317
5,1926,1872,54,1.552,1.508,0.044
5,1837,1511,326,1.480,1.217,0.263
5,2088,1880,208,1.682,1.515,0.168
5,2039,2232,-193,1.643,1.798,-0.155
5,1784,1558,226,1.437,1.255,0.182
5,2077,1713,364,1.673,1.380,0.293
5,1873,2208,-335,1.509,1.779,-0.270
5,2382,2207,175,1.919,1.778,0.141
5,1915,2196,-281,1.543,1.769,-0.226
5,1850,2088,-238,1.490,1.682,-0.192
5,2112,2182,-70,1.701,1.758,-0.056
5,1926,1673,253,1.552,1.348,0.204
5,1725,1871,-146,1.390,1.507,-0.118
,,,0,0.000,0.000,0.000
5,2124,2105,19,1.711,1.696,0.015
5,1967,1538,429,1.585,1.239,0.346
5,1939,2195,-256,1.562,1.768,-0.206
5,2220,2102,118,1.788,1.693,0.095
5,1804,1931,-127,1.453,1.556,-0.102
5,2112,2256,-144,1.701,1.817,-0.116
5,1718,1810,-92,1.384,1.458,-0.074
5,1823,1924,-101,1.469,1.550,-0.081
5,2190,2033,157,1.764,1.638,0.126
5,1941,1789,152,1.564,1.441,0.122
5,1795,1977,-182,1.446,1.593,-0.147
5,1785,1880,-95,1.438,1.515,-0.077
5,1923,2023,-100,1.549,1.630,-0.081
5,1737,1781,-44,1.399,1.435,-0.035
5,1788,1733,55,1.440,1.396,0.044
5,2209,2027,182,1.780,1.633,0.147
5,2106,1971,135,1.697,1.588,0.109
5,2360,1728,632,1.901,1.392,0.509
5,1791,2181,-390,1.443,1.757,-0.314
5,1729,1927,-198,1.393,1.552,-0.160
5,1920,1461,459,1.547,1.177,0.370
5,2094,2068,26,1.687,1.666,0.021
5,1623,2333,-710,1.307,1.879,-0.572
5,1928,1930,-2,1.553,1.555,-0.002
5,2076,2004,72,1.672,1.614,0.058
5,2280,1700,580,1.837,1.369,0.467
5,1752,1694,58,1.411,1.365,0.047
5,2055,2343,-288,1.655,1.887,-0.232
5,2041,1773,268,1.644,1.428,0.216
5,2039,1723,316,1.643,1.388,0.255
5,2402,1913,489,1.935,1.541,0.394
5,1926,2016,-90,1.552,1.624,-0.073
5,2034,1601,433,1.639,1.290,0.349
5,1718,1556,162,1.384,1.253,0.131
5,1917,2279,-362,1.544,1.836,-0.292
5,2081,2005,76,1.676,1.615,0.061
5,1765,2215,-450,1.422,1.784,-0.363
5,2392,1772,620,1.927,1.427,0.499
5,1784,1823,-39,1.437,1.469,-0.031
5,1719,2314,-595,1.385,1.864,-0.479
5,1711,1952,-241,1.378,1.573,-0.194
5,1604,1740,-136,1.292,1.402,-0.110
5,2275,2053,222,1.833,1.654,0.179
5,1504,2052,-548,1.212,1.653,-0.441
,,,0,0.000,0.000,0.000
5,1855,1989,-134,1.494,1.602,-0.108
5,2372,2035,337,1.911,1.639,0.271
5,1843,2019,-176,1.485,1.626,-0.142
5,1715,2367,-652,1.382,1.907,-0.525
5,2017,2042,-25,1.625,1.645,-0.020
5,2216,2360,-144,1.785,1.901,-0.116
5,2120,2310,-190,1.708,1.861,-0.153
5,2069,1583,486,1.667,1.275,0.392
5,2423,1988,435,1.952,1.602,0.350
5,2265,1635,630,1.825,1.317,0.508
5,1488,1846,-358,1.199,1.487,-0.288
5,1846,1972,-126,1.487,1.589,-0.102
5,1991,2228,-237,1.604,1.795,-0.191
5,2186,1616,570,1.761,1.302,0.459
5,1736,1789,-53,1.398,1.441,-0.043
5,1645,2205,-560,1.325,1.776,-0.451
5,2073,2110,-37,1.670,1.700,-0.030
5,1979,2074,-95,1.594,1.671,-0.077
5,2356,2030,326,1.898,1.635,0.263
5,1484,1692,-208,1.195,1.363,-0.168
5,2281,1693,588,1.838,1.364,0.474
5,1711,2008,-297,1.378,1.618,-0.239
5,2230,1607,623,1.796,1.295,0.502
5,1824,2372,-548,1.469,1.911,-0.441
5,2192,2278,-86,1.766,1.835,-0.069
5,1622,2284,-662,1.307,1.840,-0.533
5,1485,1743,-258,1.196,1.404,-0.208
5,2323,1538,785,1.871,1.239,0.632
5,2166,2210,-44,1.745,1.780,-0.035
5,1811,1804,7,1.459,1.453,0.006
5,2341,2018,323,1.886,1.626,0.260
5,1883,2370,-487,1.517,1.909,-0.392
5,2082,2117,-35,1.677,1.705,-0.028
5,2181,2059,122,1.757,1.659,0.098
5,1763,1647,116,1.420,1.327,0.093
5,1963,2092,-129,1.581,1.685,-0.104
5,2214,2086,128,1.784,1.680,0.103
5,1841,1964,-123,1.483,1.582,-0.099
5,1883,2230,-347,1.517,1.796,-0.280
5,1994,2176,-182,1.606,1.753,-0.147
5,1890,1838,52,1.523,1.481,0.042
5,1736,2036,-300,1.398,1.640,-0.242
5,2158,2194,-36,1.738,1.767,-0.029
5,2059,2357,-298,1.659,1.899,-0.240
5,1807,2143,-336,1.456,1.726,-0.271
5,1697,2055,-358,1.367,1.655,-0.288
5,1815,1537,278,1.462,1.238,0.224
5,2376,1984,392,1.914,1.598,0.316
5,1706,1914,-208,1.374,1.542,-0.168
5,1710,1604,106,1.378,1.292,0.085
5,2188,1763,425,1.763,1.420,0.342
5,1762,2050,-288,1.419,1.651,-0.232
5,1860,2313,-453,1.498,1.863,-0.365
5,1718,1456,262,1.384,1.173,0.211
5,1670,2226,-556,1.345,1.793,-0.448
5,1682,1622,60,1.355,1.307,0.048
5,2151,1623,528,1.733,1.307,0.425
5,2160,2251,-91,1.740,1.813,-0.073
5,2012,2265,-253,1.621,1.825,-0.204
5,2276,2060,216,1.834,1.660,0.174
5,2396,1953,443,1.930,1.573,0.357
5,2076,1810,266,1.672,1.458,0.214
5,2230,1501,729,1.796,1.209,0.587
5,2176,1907,269,1.753,1.536,0.217
5,1547,1810,-263,1.246,1.458,-0.212
5,2179,1710,469,1.755,1.378,0.378
5,2135,1764,371,1.720,1.421,0.299
5,1725,2022,-297,1.390,1.629,-0.239
5,2248,1971,277,1.811,1.588,0.223
5,2142,1870,272,1.726,1.506,0.219
5,2404,1725,679,1.937,1.390,0.547
5,2049,1477,572,1.651,1.190,0.461
5,2054,1789,265,1.655,1.441,0.213
5,1903,1750,153,1.533,1.410,0.123
5,1967,1703,264,1.585,1.372,0.213
5,1925,2106,-181,1.551,1.697,-0.146
5,2023,2056,-33,1.630,1.656,-0.027
5,1958,1693,265,1.577,1.364,0.213
5,1805,1744,61,1.454,1.405,0.049
5,2016,1495,521,1.624,1.204,0.420
5,1808,1853,-45,1.456,1.493,-0.036
5,2225,2360,-135,1.792,1.901,-0.109
5,1814,1599,215,1.461,1.288,0.173
5,2178,2064,114,1.755,1.663,0.092
5,1916,2276,-360,1.544,1.834,-0.290
5,2140,2122,18,1.724,1.709,0.015
5,1833,1561,272,1.477,1.258,0.219
5,1581,1691,-110,1.274,1.362,-0.089
5,1848,1629,219,1.489,1.312,0.176
5,1589,2140,-551,1.280,1.724,-0.444
5,2278,2093,185,1.835,1.686,0.149
5,1803,1640,163,1.452,1.321,0.131
5,1860,1698,162,1.498,1.368,0.131
5,2113,2201,-88,1.702,1.773,-0.071
5,1590,1996,-406,1.281,1.608,-0.327
5,2012,1687,325,1.621,1.359,0.262
5,1997,1582,415,1.609,1.274,0.334
5,2161,2038,123,1.741,1.642,0.099
5,2108,2185,-77,1.698,1.760,-0.062
5,1838,2073,-235,1.481,1.670,-0.189
5,1894,1721,173,1.526,1.386,0.139
5,2087,2128,-41,1.681,1.714,-0.033
5,1933,2034,-101,1.557,1.639,-0.081
5,1937,2185,-248,1.560,1.760,-0.200
5,1833,2121,-288,1.477,1.709,-0.232
5,1515,1720,-205,1.220,1.386,-0.165
5,2032,1923,109,1.637,1.549,0.088
5,2130,1611,519,1.716,1.298,0.418
5,2244,1780,464,1.808,1.434,0.374
5,1891,1781,110,1.523,1.435,0.089
5,1791,2238,-447,1.443,1.803,-0.360
5,2050,1926,124,1.651,1.552,0.100
5,1923,1777,146,1.549,1.432,0.118
5,2200,1783,417,1.772,1.436,0.336
5,1532,1528,4,1.234,1.231,0.003
5,2109,1791,318,1.699,1.443,0.256
5,2007,1789,218,1.617,1.441,0.176
5,2213,2304,-91,1.783,1.856,-0.073
5,2428,1949,479,1.956,1.570,0.386
5,2017,2048,-31,1.625,1.650,-0.025
5,1917,1489,428,1.544,1.200,0.345
5,2028,1925,103,1.634,1.551,0.083
5,1683,1619,64,1.356,1.304,0.052
5,1926,1919,7,1.552,1.546,0.006
5,1808,1752,56,1.456,1.411,0.045
5,2065,1479,586,1.664,1.191,0.472
5,2006,2037,-31,1.616,1.641,-0.025
5,1485,2304,-819,1.196,1.856,-0.660
5,2160,2196,-36,1.740,1.769,-0.029
5,1532,1835,-303,1.234,1.478,-0.244
5,1787,2117,-330,1.440,1.705,-0.266
5,2139,1774,365,1.723,1.429,0.294
5,1524,1884,-360,1.228,1.518,-0.290
5,1998,2286,-288,1.610,1.842,-0.232
5,1930,1835,95,1.555,1.478,0.077
5,1791,2392,-601,1.443,1.927,-0.484
5,1833,1925,-92,1.477,1.551,-0.074
5,2244,2381,-137,1.808,1.918,-0.110
5,1876,1666,210,1.511,1.342,0.169
5,2132,1807,325,1.718,1.456,0.262
5,2179,2002,177,1.755,1.613,0.143
5,1553,2057,-504,1.251,1.657,-0.406
5,2124,2209,-85,1.711,1.780,-0.068
5,2265,1528,737,1.825,1.231,0.594
5,1696,1940,-244,1.366,1.563,-0.197
5,1905,2186,-281,1.535,1.761,-0.226
5,1727,1928,-201,1.391,1.553,-0.162
5,1985,2384,-399,1.599,1.921,-0.321
5,2088,1512,576,1.682,1.218,0.464
5,1623,2075,-452,1.307,1.672,-0.364
5,2246,2324,-78,1.809,1.872,-0.063
5,1515,1761,-246,1.220,1.419,-0.198
5,1502,1706,-204,1.210,1.374,-0.164
5,2287,2259,28,1.842,1.820,0.023
5,2222,1989,233,1.790,1.602,0.188
5,1600,1705,-105,1.289,1.374,-0.085
5,2019,2305,-286,1.626,1.857,-0.230
5,2272,1901,371,1.830,1.531,0.299
5,1757,1910,-153,1.415,1.539,-0.123
5,1763,1651,112,1.420,1.330,0.090
5,2229,2212,17,1.796,1.782,0.014
5,2237,1873,364,1.802,1.509,0.293
5,1715,2174,-459,1.382,1.751,-0.370
5,1916,2074,-158,1.544,1.671,-0.127
5,1625,2008,-383,1.309,1.618,-0.309
5,2023,2010,13,1.630,1.619,0.010
5,2123,1903,220,1.710,1.533,0.177
5,1548,1855,-307,1.247,1.494,-0.247
5,1701,2146,-445,1.370,1.729,-0.358
5,1952,2201,-249,1.573,1.773,-0.201
5,2428,1911,517,1.956,1.539,0.416
5,1704,2208,-504,1.373,1.779,-0.406
5,1607,1765,-158,1.295,1.422,-0.127
5,1772,1883,-111,1.427,1.517,-0.089
5,1985,2222,-237,1.599,1.790,-0.191
5,1631,2083,-452,1.314,1.678,-0.364
5,1796,1793,3,1.447,1.444,0.002
5,2116,1601,515,1.705,1.290,0.415
5,2249,2222,27,1.812,1.790,0.022
5,2133,2105,28,1.718,1.696,0.023
5,1950,1862,88,1.571,1.500,0.071
5,2173,2211,-38,1.751,1.781,-0.031
5,1879,1462,417,1.514,1.178,0.336
5,1781,1891,-110,1.435,1.523,-0.089
5,2262,2135,127,1.822,1.720,0.102
5,1930,2184,-254,1.555,1.759,-0.205
5,1844,1981,-137,1.485,1.596,-0.110
5,2402,1881,521,1.935,1.515,0.420
5,2260,2037,223,1.821,1.641,0.180
5,2071,1955,116,1.668,1.575,0.093
5,1713,1865,-152,1.380,1.502,-0.122
5,1972,2058,-86,1.589,1.658,-0.069
5,1623,1667,-44,1.307,1.343,-0.035
5,1843,2356,-513,1.485,1.898,-0.413
5,2282,2062,220,1.838,1.661,0.177
5,2030,1880,150,1.635,1.515,0.121
5,2150,1842,308,1.732,1.484,0.248
5,1702,1807,-105,1.371,1.456,-0.085
5,1558,1863,-305,1.255,1.501,-0.246
5,2030,2117,-87,1.635,1.705,-0.070
5,1671,1957,-286,1.346,1.577,-0.230
5,1557,1957,-400,1.254,1.577,-0.322
5,2034,1769,265,1.639,1.425,0.213
5,2350,2127,223,1.893,1.713,0.180
5,1738,2143,-405,1.400,1.726,-0.326
5,2019,2119,-100,1.626,1.707,-0.081
5,2031,1879,152,1.636,1.514,0.122
5,2149,1677,472,1.731,1.351,0.380
5,1933,1932,1,1.557,1.556,0.001
5,1910,2101,-191,1.539,1.693,-0.154
5,2027,2222,-195,1.633,1.790,-0.157
5,2033,1666,367,1.638,1.342,0.296
5,1732,2181,-449,1.395,1.757,-0.362
5,1998,2238,-240,1.610,1.803,-0.193
5,2152,2041,111,1.734,1.644,0.089
5,1708,2112,-404,1.376,1.701,-0.325
5,1986,1982,4,1.600,1.597,0.003
5,2119,1951,168,1.707,1.572,0.135
5,1914,2219,-305,1.542,1.788,-0.246
5,1568,1871,-303,1.263,1.507,-0.244
5,2193,1886,307,1.767,1.519,0.247
5,1930,1734,196,1.555,1.397,0.158
5,1596,2107,-511,1.286,1.697,-0.412
5,2088,2074,14,1.682,1.671,0.011
5,1624,1731,-107,1.308,1.394,-0.086
5,1702,1862,-160,1.371,1.500,-0.129
5,1922,1575,347,1.548,1.269,0.280
5,1959,1815,144,1.578,1.462,0.116
5,1987,1469,518,1.601,1.183,0.417
5,1737,1979,-242,1.399,1.594,-0.195
5,1799,2202,-403,1.449,1.774,-0.325
5,2168,1997,171,1.747,1.609,0.138
5,1965,2115,-150,1.583,1.704,-0.121
5,1983,1722,261,1.597,1.387,0.210
5,2260,1995,265,1.821,1.607,0.213
5,1971,1494,477,1.588,1.204,0.384
5,1867,1649,218,1.504,1.328,0.176
5,2072,1921,151,1.669,1.548,0.122
5,2032,2277,-245,1.637,1.834,-0.197
5,1679,2036,-357,1.353,1.640,-0.288
5,1850,1525,325,1.490,1.229,0.262
5,2158,1897,261,1.738,1.528,0.210
5,1921,1815,106,1.548,1.462,0.085
5,1881,1883,-2,1.515,1.517,-0.002
5,2059,2044,15,1.659,1.647,0.012
5,1916,1956,-40,1.544,1.576,-0.032
5,1822,2064,-242,1.468,1.663,-0.195
5,1917,1716,201,1.544,1.382,0.162
5,2090,1722,368,1.684,1.387,0.296
5,1779,1622,157,1.433,1.307,0.126
5,1526,1900,-374,1.229,1.531,-0.301
5,2362,1900,462,1.903,1.531,0.372
5,2010,1852,158,1.619,1.492,0.127
5,2220,1850,370,1.788,1.490,0.298
5,1663,2166,-503,1.340,1.745,-0.405
5,2304,1879,425,1.856,1.514,0.342
5,2049,1897,152,1.651,1.528,0.122
5,2118,1803,315,1.706,1.452,0.254
5,2021,2051,-30,1.628,1.652,-0.024
5,1599,1484,115,1.288,1.195,0.093
5,1494,1690,-196,1.204,1.361,-0.158
5,1860,1709,151,1.498,1.377,0.122
5,1671,1500,171,1.346,1.208,0.138
5,2348,1921,427,1.892,1.548,0.344
5,1979,2023,-44,1.594,1.630,-0.035
5,2200,1889,311,1.772,1.522,0.251
5,2212,1535,677,1.782,1.237,0.545
5,2170,2154,16,1.748,1.735,0.013
5,1761,1819,-58,1.419,1.465,-0.047
5,2191,1613,578,1.765,1.299,0.466
5,1915,1615,300,1.543,1.301,0.242
5,1985,2370,-385,1.599,1.909,-0.310
5,2027,1958,69,1.633,1.577,0.056
5,1924,1958,-34,1.550,1.577,-0.027
5,2023,1917,106,1.630,1.544,0.085
5,1822,2381,-559,1.468,1.918,-0.450
5,1995,1884,111,1.607,1.518,0.089
5,2055,2350,-295,1.655,1.893,-0.238
5,2268,2246,22,1.827,1.809,0.018
5,1697,1582,115,1.367,1.274,0.093
5,2005,1931,74,1.615,1.556,0.060
5,2266,1835,431,1.825,1.478,0.347
5,2049,1579,470,1.651,1.272,0.379
5,1953,1500,453,1.573,1.208,0.365
5,1973,1452,521,1.589,1.170,0.420
5,2132,2220,-88,1.718,1.788,-0.071
5,2030,1968,62,1.635,1.585,0.050
5,1914,2226,-312,1.542,1.793,-0.251
5,1778,1570,208,1.432,1.265,0.168
5,1998,2140,-142,1.610,1.724,-0.114
5,1755,1583,172,1.414,1.275,0.139
5,1950,1804,146,1.571,1.453,0.118
5,1862,2210,-348,1.500,1.780,-0.280
5,2225,1748,477,1.792,1.408,0.384
5,1551,1811,-260,1.249,1.459,-0.209
5,2236,2013,223,1.801,1.622,0.180
5,1919,1657,262,1.546,1.335,0.211
5,1869,1957,-88,1.506,1.577,-0.071
5,2436,2020,416,1.962,1.627,0.335
5,1735,1785,-50,1.398,1.438,-0.040
5,1935,2034,-99,1.559,1.639,-0.080
5,1745,2042,-297,1.406,1.645,-0.239
5,1913,2206,-293,1.541,1.777,-0.236
5,2027,1763,264,1.633,1.420,0.213
5,2184,2273,-89,1.759,1.831,-0.072
5,1772,1761,11,1.427,1.419,0.009
5,2083,1658,425,1.678,1.336,0.342
5,2184,1757,427,1.759,1.415,0.344
5,2282,2063,219,1.838,1.662,0.176
5,2413,2085,328,1.944,1.680,0.264
5,2120,1638,482,1.708,1.320,0.388
5,2426,2194,232,1.954,1.767,0.187
5,1864,2217,-353,1.502,1.786,-0.284
5,1598,2150,-552,1.287,1.732,-0.445
5,2264,1840,424,1.824,1.482,0.342
5,2208,1632,576,1.779,1.315,0.464
5,2162,1861,301,1.742,1.499,0.242
5,2392,1750,642,1.927,1.410,0.517
5,2232,1703,529,1.798,1.372,0.426
5,2067,2138,-71,1.665,1.722,-0.057
5,1860,1899,-39,1.498,1.530,-0.031
5,2212,1745,467,1.782,1.406,0.376
5,2216,1898,318,1.785,1.529,0.256
5,1539,1690,-151,1.240,1.361,-0.122
5,1899,1790,109,1.530,1.442,0.088
5,2214,2345,-131,1.784,1.889,-0.106
5,1694,2358,-664,1.365,1.900,-0.535
5,2218,1936,282,1.787,1.560,0.227
5,1490,1640,-150,1.200,1.321,-0.121
5,2012,1543,469,1.621,1.243,0.378
5,2009,1985,24,1.618,1.599,0.019
5,2316,1941,375,1.866,1.564,0.302
5,2270,1947,323,1.829,1.568,0.260
5,1557,1856,-299,1.254,1.495,-0.241
5,2072,1490,582,1.669,1.200,0.469
5,1974,1861,113,1.590,1.499,0.091
5,1817,2320,-503,1.464,1.869,-0.405
5,2081,1498,583,1.676,1.207,0.470
5,2133,2061,72,1.718,1.660,0.058
5,1671,1825,-154,1.346,1.470,-0.124
5,1781,2382,-601,1.435,1.919,-0.484
5,2260,1532,728,1.821,1.234,0.586
5,1704,1999,-295,1.373,1.610,-0.238
5,2018,2053,-35,1.626,1.654,-0.028
5,1601,1952,-351,1.290,1.573,-0.283
5,1815,1559,256,1.462,1.256,0.206
5,1922,1830,92,1.548,1.474,0.074
5,1998,2299,-301,1.610,1.852,-0.242
5,1962,2163,-201,1.581,1.742,-0.162
5,1980,2023,-43,1.595,1.630,-0.035
5,1583,1896,-313,1.275,1.527,-0.252
5,2220,2107,113,1.788,1.697,0.091
5,1723,1616,107,1.388,1.302,0.086
5,2244,2075,169,1.808,1.672,0.136
5,2254,1924,330,1.816,1.550,0.266
5,2299,1881,418,1.852,1.515,0.337
5,2248,2023,225,1.811,1.630,0.181
5,1580,2127,-547,1.273,1.713,-0.441
5,1577,1975,-398,1.270,1.591,-0.321
5,2041,1462,579,1.644,1.178,0.466
5,1834,2227,-393,1.477,1.794,-0.317
5,1994,1679,315,1.606,1.353,0.254
5,1903,1798,105,1.533,1.448,0.085
5,1815,2324,-509,1.462,1.872,-0.410
5,1980,1919,61,1.595,1.546,0.049
5,1503,2161,-658,1.211,1.741,-0.530
5,1790,1573,217,1.442,1.267,0.175
5,2044,1777,267,1.647,1.432,0.215
5,1896,2040,-144,1.527,1.643,-0.116
5,2318,1590,728,1.867,1.281,0.586
5,1656,1803,-147,1.334,1.452,-0.118
5,1711,2101,-390,1.378,1.693,-0.314
5,2225,2048,177,1.792,1.650,0.143
5,1815,1503,312,1.462,1.211,0.251
5,1915,1823,92,1.543,1.469,0.074
5,1920,1609,311,1.547,1.296,0.251
5,2400,2065,335,1.933,1.664,0.270
5,1776,1663,113,1.431,1.340,0.091
5,1628,1776,-148,1.311,1.431,-0.119
5,2139,2067,72,1.723,1.665,0.058
5,2195,1776,419,1.768,1.431,0.338
5,2255,1675,580,1.817,1.349,0.467
5,2045,2229,-184,1.647,1.796,-0.148
5,1845,1987,-142,1.486,1.601,-0.114
5,2161,2091,70,1.741,1.684,0.056
5,2104,2147,-43,1.695,1.730,-0.035
5,2062,2200,-138,1.661,1.772,-0.111
5,1861,2053,-192,1.499,1.654,-0.155
5,1717,1759,-42,1.383,1.417,-0.034
5,2079,1759,320,1.675,1.417,0.258
5,1817,1505,312,1.464,1.212,0.251
5,1784,2021,-237,1.437,1.628,-0.191
5,2152,1676,476,1.734,1.350,0.383
5,1832,1567,265,1.476,1.262,0.213
5,2097,2292,-195,1.689,1.846,-0.157
5,1633,1938,-305,1.316,1.561,-0.246
5,1912,1692,220,1.540,1.363,0.177
5,2011,2196,-185,1.620,1.769,-0.149
5,1700,1938,-238,1.369,1.561,-0.192
5,2267,1895,372,1.826,1.527,0.300
5,2217,1939,278,1.786,1.562,0.224
5,1815,2222,-407,1.462,1.790,-0.328
5,1720,1725,-5,1.386,1.390,-0.004
5,1986,1679,307,1.600,1.353,0.247
5,1894,1784,110,1.526,1.437,0.089
5,1583,2089,-506,1.275,1.683,-0.408
5,2164,2147,17,1.743,1.730,0.014
5,2020,2010,10,1.627,1.619,0.008
5,2035,2020,15,1.639,1.627,0.012
5,1788,1846,-58,1.440,1.487,-0.047
5,1933,1924,9,1.557,1.550,0.007
5,1795,1630,165,1.446,1.313,0.133
5,2113,1852,261,1.702,1.492,0.210
5,1861,2060,-199,1.499,1.660,-0.160
5,2183,1723,460,1.759,1.388,0.371
5,2248,1713,535,1.811,1.380,0.431
5,1922,2176,-254,1.548,1.753,-0.205
5,1920,1509,411,1.547,1.216,0.331
5,1628,1833,-205,1.311,1.477,-0.165
5,1895,1624,271,1.527,1.308,0.218
5,1487,1903,-416,1.198,1.533,-0.335
5,2008,2312,-304,1.618,1.863,-0.245
5,1979,2226,-247,1.594,1.793,-0.199
5,1682,1784,-102,1.355,1.437,-0.082
5,1939,2037,-98,1.562,1.641,-0.079
5,1753,1800,-47,1.412,1.450,-0.038
5,2339,2010,329,1.884,1.619,0.265
5,2136,2118,18,1.721,1.706,0.015
5,1678,1789,-111,1.352,1.441,-0.089
5,2326,2109,217,1.874,1.699,0.175
5,1608,2363,-755,1.295,1.904,-0.608
5,1709,1866,-157,1.377,1.503,-0.126
5,1510,1667,-157,1.216,1.343,-0.126
5,2144,2077,67,1.727,1.673,0.054
5,2165,2057,108,1.744,1.657,0.087
5,2182,1816,366,1.758,1.463,0.295
5,1814,2317,-503,1.461,1.867,-0.405
5,2342,2371,-29,1.887,1.910,-0.023
5,2185,2020,165,1.760,1.627,0.133
5,2042,1624,418,1.645,1.308,0.337
5,2054,1847,207,1.655,1.488,0.167
5,2160,1747,413,1.740,1.407,0.333
5,1600,1854,-254,1.289,1.494,-0.205
5,1876,2388,-512,1.511,1.924,-0.412
5,2100,1691,409,1.692,1.362,0.329
5,1704,1852,-148,1.373,1.492,-0.119
5,1916,1698,218,1.544,1.368,0.176
5,1762,1960,-198,1.419,1.579,-0.160
5,1735,2027,-292,1.398,1.633,-0.235
5,2254,1897,357,1.816,1.528,0.288
5,2115,1913,202,1.704,1.541,0.163
5,1621,1923,-302,1.306,1.549,-0.243
5,2204,1921,283,1.776,1.548,0.228
5,1743,2198,-455,1.404,1.771,-0.367
5,2184,2182,2,1.759,1.758,0.002
5,1889,1978,-89,1.522,1.593,-0.072
5,2001,2255,-254,1.612,1.817,-0.205
5,2077,2214,-137,1.673,1.784,-0.110
5,1981,1827,154,1.596,1.472,0.124
5,2106,2148,-42,1.697,1.730,-0.034
5,2185,1623,562,1.760,1.307,0.453
5,1897,1636,261,1.528,1.318,0.210
5,2378,2312,66,1.916,1.863,0.053
5,1977,2068,-91,1.593,1.666,-0.073
5,1925,2084,-159,1.551,1.679,-0.128
5,1851,1853,-2,1.491,1.493,-0.002
5,1660,1663,-3,1.337,1.340,-0.002
5,1993,1892,101,1.606,1.524,0.081
5,1759,1565,194,1.417,1.261,0.156
5,1788,1684,104,1.440,1.357,0.084
5,2277,2162,115,1.834,1.742,0.093
5,1772,1915,-143,1.427,1.543,-0.115
5,1789,1745,44,1.441,1.406,0.035
5,2232,1669,563,1.798,1.345,0.454
5,2107,1903,204,1.697,1.533,0.164
5,2067,2213,-146,1.665,1.783,-0.118
5,1871,2172,-301,1.507,1.750,-0.242
5,1528,1481,47,1.231,1.193,0.038
5,2226,1958,268,1.793,1.577,0.216
5,2148,2147,1,1.730,1.730,0.001
5,2336,1881,455,1.882,1.515,0.367
5,2148,2346,-198,1.730,1.890,-0.160
5,1861,2017,-156,1.499,1.625,-0.126
5,2201,1676,525,1.773,1.350,0.423
5,1946,2208,-262,1.568,1.779,-0.211
5,2132,1880,252,1.718,1.515,0.203
5,1751,1807,-56,1.411,1.456,-0.045
5,1717,1779,-62,1.383,1.433,-0.050
5,2004,1538,466,1.614,1.239,0.375
5,2178,1502,676,1.755,1.210,0.545
5,2394,2218,176,1.929,1.787,0.142
5,1511,1764,-253,1.217,1.421,-0.204
5,2036,1980,56,1.640,1.595,0.045
5,1689,2200,-511,1.361,1.772,-0.412
5,2172,1553,619,1.750,1.251,0.499
5,1922,2181,-259,1.548,1.757,-0.209
5,2257,2237,20,1.818,1.802,0.016
5,1850,2008,-158,1.490,1.618,-0.127
5,2150,1640,510,1.732,1.321,0.411
5,2326,2320,6,1.874,1.869,0.005
5,1726,2181,-455,1.390,1.757,-0.367
5,2152,1896,256,1.734,1.527,0.206
5,1759,1954,-195,1.417,1.574,-0.157
5,1929,1785,144,1.554,1.438,0.116
5,2169,2210,-41,1.747,1.780,-0.033
5,1558,2065,-507,1.255,1.664,-0.408
5,2412,2243,169,1.943,1.807,0.136
5,2166,1811,355,1.745,1.459,0.286
5,2079,1879,200,1.675,1.514,0.161
5,2208,2000,208,1.779,1.611,0.168
5,1765,1565,200,1.422,1.261,0.161
5,1779,1470,309,1.433,1.184,0.249
5,2224,2210,14,1.792,1.780,0.011
5,2134,1884,250,1.719,1.518,0.201
5,2160,2210,-50,1.740,1.780,-0.040
5,1874,2113,-239,1.510,1.702,-0.193
5,1926,1519,407,1.552,1.224,0.328
5,1859,2223,-364,1.498,1.791,-0.293
5,2366,2103,263,1.906,1.694,0.212
5,1974,1775,199,1.590,1.430,0.160
5,2312,2256,56,1.863,1.817,0.045
5,1967,1499,468,1.585,1.208,0.377
5,1923,2131,-208,1.549,1.717,-0.168
5,1843,1901,-58,1.485,1.531,-0.047
5,2326,2041,285,1.874,1.644,0.230
5,2014,2003,11,1.622,1.614,0.009
5,1672,2283,-611,1.347,1.839,-0.492
5,2205,1489,716,1.776,1.200,0.577
5,1968,2158,-190,1.585,1.738,-0.153
5,1819,1827,-8,1.465,1.472,-0.006
5,2254,2196,58,1.816,1.769,0.047
5,1936,1741,195,1.560,1.403,0.157
5,2171,2153,18,1.749,1.734,0.015
5,2224,2000,224,1.792,1.611,0.180
5,1915,2019,-104,1.543,1.626,-0.084
5,1631,1803,-172,1.314,1.452,-0.139
5,2228,1711,517,1.795,1.378,0.416
5,2194,2080,114,1.767,1.676,0.092
5,1941,1942,-1,1.564,1.564,-0.001
5,2021,1928,93,1.628,1.553,0.075
5,2360,1852,508,1.901,1.492,0.409
5,1701,2060,-359,1.370,1.660,-0.289
5,2250,1677,573,1.813,1.351,0.462
5,1747,2004,-257,1.407,1.614,-0.207
5,1884,2137,-253,1.518,1.722,-0.204
5,1544,1944,-400,1.244,1.566,-0.322
5,2019,2220,-201,1.626,1.788,-0.162
5,2044,1528,516,1.647,1.231,0.416
5,1858,2008,-150,1.497,1.618,-0.121
5,1778,1729,49,1.432,1.393,0.039
5,2062,1961,101,1.661,1.580,0.081
5,1895,2098,-203,1.527,1.690,-0.164
5,1951,1919,32,1.572,1.546,0.026
5,1623,1579,44,1.307,1.272,0.035
5,2212,1533,679,1.782,1.235,0.547
5,2276,2006,270,1.834,1.616,0.218
5,1988,2032,-44,1.602,1.637,-0.035
5,1962,1997,-35,1.581,1.609,-0.028
5,2019,1615,404,1.626,1.301,0.325
5,2049,1903,146,1.651,1.533,0.118
5,2022,2131,-109,1.629,1.717,-0.088
5,2210,2104,106,1.780,1.695,0.085
5,1767,1622,145,1.423,1.307,0.117
5,2060,1487,573,1.660,1.198,0.462
5,1664,2228,-564,1.340,1.795,-0.454
5,2113,2041,72,1.702,1.644,0.058
5,2225,1918,307,1.792,1.545,0.247
5,1840,1902,-62,1.482,1.532,-0.050
5,2334,1513,821,1.880,1.219,0.661
5,2106,1907,199,1.697,1.536,0.160
5,2073,2170,-97,1.670,1.748,-0.078
5,2160,2314,-154,1.740,1.864,-0.124
5,2352,2144,208,1.895,1.727,0.168
5,2178,1964,214,1.755,1.582,0.172
5,2246,2225,21,1.809,1.792,0.017
5,1791,2304,-513,1.443,1.856,-0.413
5,1815,2219,-404,1.462,1.788,-0.325
5,1625,1904,-279,1.309,1.534,-0.225
5,2176,1661,515,1.753,1.338,0.415
5,1831,1567,264,1.475,1.262,0.213
5,1743,1932,-189,1.404,1.556,-0.152
5,1947,2048,-101,1.568,1.650,-0.081
5,2287,2234,53,1.842,1.800,0.043
5,2051,1897,154,1.652,1.528,0.124
5,2280,1711,569,1.837,1.378,0.458
5,1878,1675,203,1.513,1.349,0.164
5,1840,1928,-88,1.482,1.553,-0.071
5,1964,1952,12,1.582,1.573,0.010
5,1913,2217,-304,1.541,1.786,-0.245
5,1912,1925,-13,1.540,1.551,-0.010
5,2141,1898,243,1.725,1.529,0.196
5,2266,1912,354,1.825,1.540,0.285
5,2236,2324,-88,1.801,1.872,-0.071
5,1787,1845,-58,1.440,1.486,-0.047
5,1491,1957,-466,1.201,1.577,-0.375
5,2038,1924,114,1.642,1.550,0.092
5,1795,1847,-52,1.446,1.488,-0.042
5,1815,2063,-248,1.462,1.662,-0.200
5,1684,1787,-103,1.357,1.440,-0.083
5,1899,1944,-45,1.530,1.566,-0.036
5,1507,1965,-458,1.214,1.583,-0.369
5,2266,2147,119,1.825,1.730,0.096
5,1706,1815,-109,1.374,1.462,-0.088
5,2249,1883,366,1.812,1.517,0.295
5,1740,1745,-5,1.402,1.406,-0.004
5,2228,1546,682,1.795,1.245,0.549
5,1871,2064,-193,1.507,1.663,-0.155
5,1826,2224,-398,1.471,1.792,-0.321
5,2410,1791,619,1.941,1.443,0.499
5,2365,2039,326,1.905,1.643,0.263
5,1495,1554,-59,1.204,1.252,-0.048
5,1675,1619,56,1.349,1.304,0.045
5,1529,1994,-465,1.232,1.606,-0.375
5,2067,1711,356,1.665,1.378,0.287
5,2234,1871,363,1.800,1.507,0.292
5,2251,1825,426,1.813,1.470,0.343
5,2201,1734,467,1.773,1.397,0.376
5,1751,1948,-197,1.411,1.569,-0.159
5,1826,1923,-97,1.471,1.549,-0.078
5,2126,2069,57,1.713,1.667,0.046
5,2088,2079,9,1.682,1.675,0.007
5,1537,1904,-367,1.238,1.534,-0.296
5,2230,2013,217,1.796,1.622,0.175
5,1992,2027,-35,1.605,1.633,-0.028
5,2354,1682,672,1.896,1.355,0.541
5,2212,2188,24,1.782,1.763,0.019
5,2052,1886,166,1.653,1.519,0.134
5,2046,1475,571,1.648,1.188,0.460
5,2010,1758,252,1.619,1.416,0.203
5,2226,1754,472,1.793,1.413,0.380
5,2015,1815,200,1.623,1.462,0.161
5,2385,1801,584,1.921,1.451,0.470
5,2427,1801,626,1.955,1.451,0.504
5,1550,1702,-152,1.249,1.371,-0.122
5,2340,2023,317,1.885,1.630,0.255
5,2045,2390,-345,1.647,1.925,-0.278
5,1986,2014,-28,1.600,1.622,-0.023
5,1575,1838,-263,1.269,1.481,-0.212
5,2006,1901,105,1.616,1.531,0.085
5,1701,1697,4,1.370,1.367,0.003
5,2023,1457,566,1.630,1.174,0.456
5,2042,1689,353,1.645,1.361,0.284
5,1606,1659,-53,1.294,1.336,-0.043
5,2214,1907,307,1.784,1.536,0.247
5,1518,1487,31,1.223,1.198,0.025
5,1513,2240,-727,1.219,1.805,-0.586
5,1873,1992,-119,1.509,1.605,-0.096
5,1676,1698,-22,1.350,1.368,-0.018
5,1828,1905,-77,1.473,1.535,-0.062
5,1774,2148,-374,1.429,1.730,-0.301
5,1673,2251,-578,1.348,1.813,-0.466
5,1720,1478,242,1.386,1.191,0.195
5,2023,1811,212,1.630,1.459,0.171
5,1726,1522,204,1.390,1.226,0.164
5,2001,2156,-155,1.612,1.737,-0.125
5,2022,2111,-89,1.629,1.701,-0.072
5,1875,1831,44,1.510,1.475,0.035
5,1750,1902,-152,1.410,1.532,-0.122
5,1915,2126,-211,1.543,1.713,-0.170
5,2208,2048,160,1.779,1.650,0.129
5,1563,2282,-719,1.259,1.838,-0.579
5,1808,1718,90,1.456,1.384,0.073
5,1909,1453,456,1.538,1.171,0.367
5,2224,1521,703,1.792,1.225,0.566
5,2066,1870,196,1.664,1.506,0.158
5,1778,1633,145,1.432,1.316,0.117
5,2233,2183,50,1.799,1.759,0.040
5,1902,1909,-7,1.532,1.538,-0.006
5,2133,2391,-258,1.718,1.926,-0.208
5,1496,2373,-877,1.205,1.912,-0.706
5,1778,1737,41,1.432,1.399,0.033
5,2062,1811,251,1.661,1.459,0.202
5,1831,1782,49,1.475,1.436,0.039
5,1803,1703,100,1.452,1.372,0.081
,,,0,0.000,0.000,0.000
5,2077,2067,10,1.673,1.665,0.008
5,1928,1888,40,1.553,1.521,0.032
5,1850,1487,363,1.490,1.198,0.292
5,1715,1730,-15,1.382,1.394,-0.012
5,1966,1861,105,1.584,1.499,0.085
5,1655,2067,-412,1.333,1.665,-0.332
5,1641,1940,-299,1.322,1.563,-0.241
5,2400,2187,213,1.933,1.762,0.172
5,2272,1813,459,1.830,1.461,0.370
5,1831,2176,-345,1.475,1.753,-0.278
5,2158,2143,15,1.738,1.726,0.012
5,2386,2215,171,1.922,1.784,0.138
5,1723,1734,-11,1.388,1.397,-0.009
5,1806,1599,207,1.455,1.288,0.167
5,1511,1623,-112,1.217,1.307,-0.090
5,2270,1535,735,1.829,1.237,0.592
5,1663,1829,-166,1.340,1.473,-0.134
5,2007,1703,304,1.617,1.372,0.245
5,2038,2136,-98,1.642,1.721,-0.079
5,2019,2119,-100,1.626,1.707,-0.081
5,2084,2188,-104,1.679,1.763,-0.084
5,2275,1656,619,1.833,1.334,0.499
5,1775,1622,153,1.430,1.307,0.123
5,2252,2038,214,1.814,1.642,0.172
5,2274,2000,274,1.832,1.611,0.221
5,1504,2104,-600,1.212,1.695,-0.483
5,2240,1663,577,1.805,1.340,0.465
5,1671,2122,-451,1.346,1.709,-0.363
5,1991,1903,88,1.604,1.533,0.071
5,2229,2172,57,1.796,1.750,0.046
5,1896,1785,111,1.527,1.438,0.089
5,1550,2165,-615,1.249,1.744,-0.495
5,2150,1472,678,1.732,1.186,0.546
5,2066,1811,255,1.664,1.459,0.205
5,1668,1519,149,1.344,1.224,0.120
,,,0,0.000,0.000,0.000
5,2176,1803,373,1.753,1.452,0.300
5,1819,1712,107,1.465,1.379,0.086
5,2188,1970,218,1.763,1.587,0.176
5,2107,1802,305,1.697,1.452,0.246
5,2019,1603,416,1.626,1.291,0.335
5,1774,2174,-400,1.429,1.751,-0.322
5,2092,1731,361,1.685,1.394,0.291
5,1577,1788,-211,1.270,1.440,-0.170
5,2268,2048,220,1.827,1.650,0.177
5,2388,2010,378,1.924,1.619,0.305
5,2196,2077,119,1.769,1.673,0.096
5,1846,1791,55,1.487,1.443,0.044
,,,0,0.000,0.000,0.000
5,1995,1726,269,1.607,1.390,0.217
5,2155,2021,134,1.736,1.628,0.108
5,2027,2367,-340,1.633,1.907,-0.274
5,1861,1699,162,1.499,1.369,0.131
5,1751,1790,-39,1.411,1.442,-0.031
5,1686,1828,-142,1.358,1.473,-0.114
5,2042,2177,-135,1.645,1.754,-0.109
5,2101,1471,630,1.693,1.185,0.508
5,1994,1734,260,1.606,1.397,0.209
5,1745,1934,-189,1.406,1.558,-0.152
5,1652,2112,-460,1.331,1.701,-0.371
5,2042,1974,68,1.645,1.590,0.055
5,1897,1901,-4,1.528,1.531,-0.003
5,1909,1859,50,1.538,1.498,0.040
5,1675,1838,-163,1.349,1.481,-0.131
5,1593,1940,-347,1.283,1.563,-0.280
5,2180,1854,326,1.756,1.494,0.263
5,2281,1506,775,1.838,1.213,0.624
5,2256,2311,-55,1.817,1.862,-0.044
5,2133,1773,360,1.718,1.428,0.290
5,1774,2069,-295,1.429,1.667,-0.238
5,1926,1925,1,1.552,1.551,0.001
5,2163,1849,314,1.742,1.490,0.253
5,2263,1749,514,1.823,1.409,0.414
5,1921,1871,50,1.548,1.507,0.040
5,2035,1968,67,1.639,1.585,0.054
5,1995,1934,61,1.607,1.558,0.049
5,2068,2314,-246,1.666,1.864,-0.198
5,1716,2060,-344,1.382,1.660,-0.277
5,1509,1875,-366,1.216,1.510,-0.295
5,1778,2172,-394,1.432,1.750,-0.317
5,1995,2028,-33,1.607,1.634,-0.027
5,1803,2301,-498,1.452,1.854,-0.401
5,2065,1944,121,1.664,1.566,0.097
5,2179,1551,628,1.755,1.249,0.506
5,2036,1771,265,1.640,1.427,0.213
5,1574,2176,-602,1.268,1.753,-0.485
5,1781,1511,270,1.435,1.217,0.218
5,1841,1581,260,1.483,1.274,0.209
5,1702,1499,203,1.371,1.208,0.164
5,2192,1922,270,1.766,1.548,0.218
5,1772,2115,-343,1.427,1.704,-0.276
5,2197,1674,523,1.770,1.349,0.421
5,1740,1838,-98,1.402,1.481,-0.079
5,2053,1846,207,1.654,1.487,0.167
5,1960,1954,6,1.579,1.574,0.005
5,1721,1777,-56,1.386,1.432,-0.045
5,2364,1583,781,1.904,1.275,0.629
5,1759,1819,-60,1.417,1.465,-0.048
5,2084,1761,323,1.679,1.419,0.260
5,1877,1920,-43,1.512,1.547,-0.035
5,1846,1687,159,1.487,1.359,0.128
5,2273,1598,675,1.831,1.287,0.544
5,1618,2282,-664,1.303,1.838,-0.535
5,2258,1935,323,1.819,1.559,0.260
5,2227,2153,74,1.794,1.734,0.060
5,2183,1878,305,1.759,1.513,0.246
5,2150,1807,343,1.732,1.456,0.276
5,1760,1922,-162,1.418,1.548,-0.131
5,1727,1791,-64,1.391,1.443,-0.052
5,1963,1906,57,1.581,1.535,0.046
5,2075,1968,107,1.672,1.585,0.086
5,1929,1984,-55,1.554,1.598,-0.044
5,1588,1940,-352,1.279,1.563,-0.284
5,1751,2309,-558,1.411,1.860,-0.450
5,1871,1556,315,1.507,1.253,0.254
5,2248,1787,461,1.811,1.440,0.371
5,1495,2169,-674,1.204,1.747,-0.543
5,2192,1462,730,1.766,1.178,0.588
5,1899,1942,-43,1.530,1.564,-0.035
5,2176,1761,415,1.753,1.419,0.334
5,1683,1886,-203,1.356,1.519,-0.164
5,2060,1696,364,1.660,1.366,0.293
5,2232,2340,-108,1.798,1.885,-0.087
5,1485,1899,-414,1.196,1.530,-0.334
5,2166,2096,70,1.745,1.689,0.056
5,1705,1813,-108,1.374,1.461,-0.087
5,2196,1839,357,1.769,1.481,0.288
5,1894,2134,-240,1.526,1.719,-0.193
5,1937,2239,-302,1.560,1.804,-0.243
5,2169,1903,266,1.747,1.533,0.214
5,1707,2152,-445,1.375,1.734,-0.358
5,1595,1488,107,1.285,1.199,0.086
5,1663,1917,-254,1.340,1.544,-0.205
5,2345,1817,528,1.889,1.464,0.425
5,1920,1912,8,1.547,1.540,0.006
5,1724,1659,65,1.389,1.336,0.052
5,1923,1827,96,1.549,1.472,0.077
5,2302,2073,229,1.854,1.670,0.184
5,1826,1659,167,1.471,1.336,0.135
5,1952,1848,104,1.573,1.489,0.084
5,1708,2151,-443,1.376,1.733,-0.357
5,1807,2056,-249,1.456,1.656,-0.201
5,2124,2002,122,1.711,1.613,0.098
5,2126,1549,577,1.713,1.248,0.465
5,2284,2166,118,1.840,1.745,0.095
,,,0,0.000,0.000,0.000
5,1516,1459,57,1.221,1.175,0.046
5,1891,1975,-84,1.523,1.591,-0.068
5,1735,2084,-349,1.398,1.679,-0.281
5,1688,1727,-39,1.360,1.391,-0.031
5,2044,1782,262,1.647,1.436,0.211
5,2102,1835,267,1.693,1.478,0.215
5,1799,2095,-296,1.449,1.688,-0.238
5,1916,1603,313,1.544,1.291,0.252
5,1512,1770,-258,1.218,1.426,-0.208
5,1780,2221,-441,1.434,1.789,-0.355
5,2138,1875,263,1.722,1.510,0.212
5,1527,2200,-673,1.230,1.772,-0.542
5,1706,2107,-401,1.374,1.697,-0.323
5,1813,2214,-401,1.461,1.784,-0.323
5,1777,2223,-446,1.432,1.791,-0.359
5,1570,2181,-611,1.265,1.757,-0.492
5,2165,2257,-92,1.744,1.818,-0.074
5,1592,1800,-208,1.282,1.450,-0.168
5,1709,1594,115,1.377,1.284,0.093
5,2290,1812,478,1.845,1.460,0.385
5,2140,2022,118,1.724,1.629,0.095
5,2096,1841,255,1.689,1.483,0.205
5,1847,1538,309,1.488,1.239,0.249
5,1718,1913,-195,1.384,1.541,-0.157
5,2153,1472,681,1.734,1.186,0.549
5,1737,1736,1,1.399,1.398,0.001
5,2011,1641,370,1.620,1.322,0.298
5,1854,1952,-98,1.494,1.573,-0.079
5,1557,2370,-813,1.254,1.909,-0.655
5,2244,2021,223,1.808,1.628,0.180
5,2254,1738,516,1.816,1.400,0.416
5,1700,1915,-215,1.369,1.543,-0.173
5,1617,2020,-403,1.303,1.627,-0.325
5,1735,2124,-389,1.398,1.711,-0.313
5,1838,2034,-196,1.481,1.639,-0.158
5,2212,1543,669,1.782,1.243,0.539
5,1867,1964,-97,1.504,1.582,-0.078
5,1988,1517,471,1.602,1.222,0.379
5,2104,2202,-98,1.695,1.774,-0.079
5,1551,2309,-758,1.249,1.860,-0.611
5,1919,2163,-244,1.546,1.742,-0.197
5,2185,2278,-93,1.760,1.835,-0.075
5,1616,2328,-712,1.302,1.875,-0.574
5,2091,1839,252,1.684,1.481,0.203
5,1753,1851,-98,1.412,1.491,-0.079
5,1807,1801,6,1.456,1.451,0.005
5,1811,1866,-55,1.459,1.503,-0.044
5,1816,1548,268,1.463,1.247,0.216
5,1774,2224,-450,1.429,1.792,-0.363
5,1982,1883,99,1.597,1.517,0.080
5,2362,2132,230,1.903,1.718,0.185
5,2212,1993,219,1.782,1.606,0.176
5,1819,2067,-248,1.465,1.665,-0.200
5,1682,2080,-398,1.355,1.676,-0.321
5,1958,2316,-358,1.577,1.866,-0.288
5,1817,1713,104,1.464,1.380,0.084
5,1835,1898,-63,1.478,1.529,-0.051
5,2170,1494,676,1.748,1.204,0.545
5,2023,1925,98,1.630,1.551,0.079
5,1932,1681,251,1.556,1.354,0.202
5,1861,2370,-509,1.499,1.909,-0.410
5,2092,2027,65,1.685,1.633,0.052
5,2260,1976,284,1.821,1.592,0.229
5,1589,1899,-310,1.280,1.530,-0.250
5,1700,1643,57,1.369,1.324,0.046
5,1863,2111,-248,1.501,1.701,-0.200
5,2240,1621,619,1.805,1.306,0.499
5,1637,1686,-49,1.319,1.358,-0.039
5,1750,1939,-189,1.410,1.562,-0.152
5,2064,1808,256,1.663,1.456,0.206
5,2182,1883,299,1.758,1.517,0.241
5,2256,1478,778,1.817,1.191,0.627
5,2015,1961,54,1.623,1.580,0.044
5,2096,2245,-149,1.689,1.809,-0.120
5,2072,1827,245,1.669,1.472,0.197
5,1733,2076,-343,1.396,1.672,-0.276
5,2253,1679,574,1.815,1.353,0.462
5,1852,1742,110,1.492,1.403,0.089
5,1952,1946,6,1.573,1.568,0.005
5,2330,1550,780,1.877,1.249,0.628
5,2185,2229,-44,1.760,1.796,-0.035
5,1936,1527,409,1.560,1.230,0.329
5,2422,2141,281,1.951,1.725,0.226
5,2169,1842,327,1.747,1.484,0.263
5,1905,2041,-136,1.535,1.644,-0.110
5,1748,2310,-562,1.408,1.861,-0.453
5,1756,1807,-51,1.415,1.456,-0.041
5,2128,1955,173,1.714,1.575,0.139
5,2192,1833,359,1.766,1.477,0.289
5,2201,2233,-32,1.773,1.799,-0.026
5,1737,2134,-397,1.399,1.719,-0.320
5,2108,1741,367,1.698,1.403,0.296
5,1919,1953,-34,1.546,1.573,-0.027
5,2339,1816,523,1.884,1.463,0.421
5,1917,2072,-155,1.544,1.669,-0.125
5,2259,1690,569,1.820,1.361,0.458
5,2163,1986,177,1.742,1.600,0.143
5,2168,1859,309,1.747,1.498,0.249
5,2017,2004,13,1.625,1.614,0.010
5,1658,1867,-209,1.336,1.504,-0.168
5,1915,2065,-150,1.543,1.664,-0.121
5,1828,2072,-244,1.473,1.669,-0.197
5,2102,1788,314,1.693,1.440,0.253
5,2263,1480,783,1.823,1.192,0.631
5,2013,2160,-147,1.622,1.740,-0.118
5,2277,1908,369,1.834,1.537,0.297
5,1604,2270,-666,1.292,1.829,-0.537
5,1671,1775,-104,1.346,1.430,-0.084
5,1993,1974,19,1.606,1.590,0.015
5,1738,1520,218,1.400,1.224,0.176
5,2204,1633,571,1.776,1.316,0.460
5,1902,1686,216,1.532,1.358,0.174
5,1900,2145,-245,1.531,1.728,-0.197
5,2219,1582,637,1.788,1.274,0.513
5,2261,1788,473,1.821,1.440,0.381
5,1543,1855,-312,1.243,1.494,-0.251
5,1606,1948,-342,1.294,1.569,-0.276
5,1871,1552,319,1.507,1.250,0.257
5,1711,2108,-397,1.378,1.698,-0.320
5,1775,1775,0,1.430,1.430,0.000
5,2038,2280,-242,1.642,1.837,-0.195
5,2205,2038,167,1.776,1.642,0.135
5,1967,2120,-153,1.585,1.708,-0.123
5,1821,2104,-283,1.467,1.695,-0.228
5,1815,1656,159,1.462,1.334,0.128
5,2088,2142,-54,1.682,1.726,-0.044
5,1850,1851,-1,1.490,1.491,-0.001
5,1501,1658,-157,1.209,1.336,-0.126
5,1916,1772,144,1.544,1.427,0.116
5,2144,1789,355,1.727,1.441,0.286
5,1590,2208,-618,1.281,1.779,-0.498
5,1983,1772,211,1.597,1.427,0.170
5,1930,2088,-158,1.555,1.682,-0.127
5,1918,2167,-249,1.545,1.746,-0.201
5,1880,2227,-347,1.515,1.794,-0.280
5,1846,2048,-202,1.487,1.650,-0.163
,,,0,0.000,0.000,0.000
5,1679,2385,-706,1.353,1.921,-0.569
5,1694,1637,57,1.365,1.319,0.046
5,1763,1719,44,1.420,1.385,0.035
5,1849,1546,303,1.490,1.245,0.244
5,1769,1459,310,1.425,1.175,0.250
5,2151,1924,227,1.733,1.550,0.183
5,2172,1643,529,1.750,1.324,0.426
5,1503,2220,-717,1.211,1.788,-0.578
5,2039,2136,-97,1.643,1.721,-0.078
5,2071,1659,412,1.668,1.336,0.332
5,1758,1500,258,1.416,1.208,0.208
5,1985,2236,-251,1.599,1.801,-0.202
5,1746,1589,157,1.407,1.280,0.126
5,2226,1921,305,1.793,1.548,0.246
5,2135,1513,622,1.720,1.219,0.501
5,2251,1681,570,1.813,1.354,0.459
5,1744,1528,216,1.405,1.231,0.174
5,2116,2057,59,1.705,1.657,0.048
5,1922,2235,-313,1.548,1.800,-0.252
5,1735,1891,-156,1.398,1.523,-0.126
5,2202,2233,-31,1.774,1.799,-0.025
5,1690,2243,-553,1.361,1.807,-0.445
5,1650,1554,96,1.329,1.252,0.077
5,2144,2087,57,1.727,1.681,0.046
5,2418,2208,210,1.948,1.779,0.169
5,1768,2127,-359,1.424,1.713,-0.289
5,2045,1477,568,1.647,1.190,0.458
5,2065,1749,316,1.664,1.409,0.255
5,2073,1867,206,1.670,1.504,0.166
5,2038,1982,56,1.642,1.597,0.045
5,1807,2164,-357,1.456,1.743,-0.288
5,1727,1832,-105,1.391,1.476,-0.085
5,1692,1743,-51,1.363,1.404,-0.041
5,2231,2018,213,1.797,1.626,0.172
5,1520,1472,48,1.224,1.186,0.039
5,1739,1690,49,1.401,1.361,0.039
5,1706,1603,103,1.374,1.291,0.083
5,2032,2022,10,1.637,1.629,0.008
5,1845,1988,-143,1.486,1.602,-0.115
5,2062,1996,66,1.661,1.608,0.053
5,2076,1960,116,1.672,1.579,0.093
5,1839,1927,-88,1.481,1.552,-0.071
5,1705,2320,-615,1.374,1.869,-0.495
5,2146,2329,-183,1.729,1.876,-0.147
5,1985,1975,10,1.599,1.591,0.008
5,1806,1851,-45,1.455,1.491,-0.036
5,1917,1956,-39,1.544,1.576,-0.031
5,2027,2120,-93,1.633,1.708,-0.075
5,2140,1466,674,1.724,1.181,0.543
5,2204,1688,516,1.776,1.360,0.416
5,1648,2052,-404,1.328,1.653,-0.325
5,2016,1555,461,1.624,1.253,0.371
5,2396,1831,565,1.930,1.475,0.455
5,1926,1470,456,1.552,1.184,0.367
5,2050,2152,-102,1.651,1.734,-0.082
5,1664,2014,-350,1.340,1.622,-0.282
5,2090,1976,114,1.684,1.592,0.092
5,2259,2144,115,1.820,1.727,0.093
5,1556,2169,-613,1.253,1.747,-0.494
5,2096,1949,147,1.689,1.570,0.118
5,1570,1727,-157,1.265,1.391,-0.126
5,1594,1953,-359,1.284,1.573,-0.289
5,1515,1839,-324,1.220,1.481,-0.261
5,1598,1660,-62,1.287,1.337,-0.050
5,2044,1940,104,1.647,1.563,0.084
5,2187,1520,667,1.762,1.224,0.537
5,2169,1773,396,1.747,1.428,0.319
5,2218,2220,-2,1.787,1.788,-0.002
5,2249,2090,159,1.812,1.684,0.128
5,1713,2226,-513,1.380,1.793,-0.413
5,1930,1792,138,1.555,1.444,0.111
5,2013,2059,-46,1.622,1.659,-0.037
5,1991,2142,-151,1.604,1.726,-0.122
5,2343,2232,111,1.887,1.798,0.089
5,2267,1916,351,1.826,1.544,0.283
5,1622,2291,-669,1.307,1.846,-0.539
5,1966,2070,-104,1.584,1.668,-0.084
5,1693,1644,49,1.364,1.324,0.039
5,1823,1920,-97,1.469,1.547,-0.078
5,2270,1495,775,1.829,1.204,0.624
5,1880,2027,-147,1.515,1.633,-0.118
5,1593,2001,-408,1.283,1.612,-0.329
5,1662,1607,55,1.339,1.295,0.044
5,1838,2045,-207,1.481,1.647,-0.167
5,1518,1934,-416,1.223,1.558,-0.335
5,2133,1623,510,1.718,1.307,0.411
5,1868,2180,-312,1.505,1.756,-0.251
5,2011,1775,236,1.620,1.430,0.190
5,2173,2177,-4,1.751,1.754,-0.003
5,1501,1928,-427,1.209,1.553,-0.344
5,2190,2162,28,1.764,1.742,0.023
5,1596,1882,-286,1.286,1.516,-0.230
5,2135,2366,-231,1.720,1.906,-0.186
5,1944,1625,319,1.566,1.309,0.257
5,2433,2183,250,1.960,1.759,0.201
5,1871,1540,331,1.507,1.241,0.267
5,1738,2172,-434,1.400,1.750,-0.350
5,1646,1726,-80,1.326,1.390,-0.064
5,2125,2033,92,1.712,1.638,0.074
5,1617,2200,-583,1.303,1.772,-0.470
5,2256,1915,341,1.817,1.543,0.275
5,2003,2030,-27,1.614,1.635,-0.022
5,1821,1682,139,1.467,1.355,0.112
5,1817,1933,-116,1.464,1.557,-0.093
5,2192,1907,285,1.766,1.536,0.230
5,1795,2104,-309,1.446,1.695,-0.249
5,1741,2376,-635,1.403,1.914,-0.512
5,1941,1827,114,1.564,1.472,0.092
5,2019,2028,-9,1.626,1.634,-0.007
5,1570,1861,-291,1.265,1.499,-0.234
5,2264,2104,160,1.824,1.695,0.129
5,1784,2106,-322,1.437,1.697,-0.259
5,1837,2203,-366,1.480,1.775,-0.295
5,2256,1808,448,1.817,1.456,0.361
5,1743,1916,-173,1.404,1.544,-0.139
5,1637,2159,-522,1.319,1.739,-0.421
5,2184,1884,300,1.759,1.518,0.242
5,1538,2375,-837,1.239,1.913,-0.674
5,2048,2210,-162,1.650,1.780,-0.131
5,2399,1827,572,1.933,1.472,0.461
5,2051,1692,359,1.652,1.363,0.289
5,1606,1762,-156,1.294,1.419,-0.126
5,1916,2050,-134,1.544,1.651,-0.108
5,1725,1857,-132,1.390,1.496,-0.106
5,2044,1855,189,1.647,1.494,0.152
5,1719,1689,30,1.385,1.361,0.024
5,2030,2292,-262,1.635,1.846,-0.211
5,2015,2162,-147,1.623,1.742,-0.118
5,1884,1714,170,1.518,1.381,0.137
5,1759,2196,-437,1.417,1.769,-0.352
5,2108,1979,129,1.698,1.594,0.104
5,1937,2339,-402,1.560,1.884,-0.324
5,1831,2080,-249,1.475,1.676,-0.201
5,2199,1666,533,1.771,1.342,0.429
5,1979,1611,368,1.594,1.298,0.296
5,1885,2032,-147,1.519,1.637,-0.118
5,1867,2141,-274,1.504,1.725,-0.221
5,1514,1799,-285,1.220,1.449,-0.230
5,2403,1990,413,1.936,1.603,0.333
5,1682,1896,-214,1.355,1.527,-0.172
5,1887,1936,-49,1.520,1.560,-0.039
5,1641,2096,-455,1.322,1.689,-0.367
5,1823,2048,-225,1.469,1.650,-0.181
5,2406,2049,357,1.938,1.651,0.288
5,2100,1708,392,1.692,1.376,0.316
5,1900,2304,-404,1.531,1.856,-0.325
5,2018,2317,-299,1.626,1.867,-0.241
5,1762,1547,215,1.419,1.246,0.173
5,1516,1589,-73,1.221,1.280,-0.059
5,2250,1795,455,1.813,1.446,0.367
5,1510,1516,-6,1.216,1.221,-0.005
5,1504,2179,-675,1.212,1.755,-0.544
5,1847,2104,-257,1.488,1.695,-0.207
5,1777,1795,-18,1.432,1.446,-0.015
5,1969,1967,2,1.586,1.585,0.002
5,1899,1815,84,1.530,1.462,0.068
5,2036,2019,17,1.640,1.626,0.014
5,1881,2280,-399,1.515,1.837,-0.321
5,2109,1921,188,1.699,1.548,0.151
5,1944,1877,67,1.566,1.512,0.054
5,2163,1460,703,1.742,1.176,0.566
5,2166,2124,42,1.745,1.711,0.034
5,2059,2197,-138,1.659,1.770,-0.111
5,1969,2061,-92,1.586,1.660,-0.074
5,1797,1876,-79,1.448,1.511,-0.064
5,1954,1676,278,1.574,1.350,0.224
5,2068,1664,404,1.666,1.340,0.325
5,2154,1861,293,1.735,1.499,0.236
5,1736,2096,-360,1.398,1.689,-0.290
5,1570,1632,-62,1.265,1.315,-0.050
5,1811,1818,-7,1.459,1.465,-0.006
5,1788,1591,197,1.440,1.282,0.159
5,2197,1911,286,1.770,1.539,0.230
5,1563,2170,-607,1.259,1.748,-0.489
5,2283,2101,182,1.839,1.693,0.147
5,1544,2039,-495,1.244,1.643,-0.399
5,2061,1699,362,1.660,1.369,0.292
5,1561,2176,-615,1.258,1.753,-0.495
5,1990,1840,150,1.603,1.482,0.121
5,1553,1563,-10,1.251,1.259,-0.008
5,1542,2122,-580,1.242,1.709,-0.467
5,1853,1449,404,1.493,1.167,0.325
5,1730,1472,258,1.394,1.186,0.208
5,1915,1966,-51,1.543,1.584,-0.041
5,2400,2233,167,1.933,1.799,0.135
5,2003,1698,305,1.614,1.368,0.246
5,1764,1818,-54,1.421,1.465,-0.044
5,1776,1735,41,1.431,1.398,0.033
5,2168,1859,309,1.747,1.498,0.249
5,1503,1904,-401,1.211,1.534,-0.323
5,2103,2189,-86,1.694,1.763,-0.069
5,1929,2225,-296,1.554,1.792,-0.238
5,2344,2216,128,1.888,1.785,0.103
5,2204,1703,501,1.776,1.372,0.404
5,2252,2195,57,1.814,1.768,0.046
5,1497,1709,-212,1.206,1.377,-0.171
5,1974,2006,-32,1.590,1.616,-0.026
5,2229,1958,271,1.796,1.577,0.218
5,2238,1929,309,1.803,1.554,0.249
5,1907,1915,-8,1.536,1.543,-0.006
5,1775,2101,-326,1.430,1.693,-0.263
5,1875,1927,-52,1.510,1.552,-0.042
5,1544,2201,-657,1.244,1.773,-0.529
5,1713,2072,-359,1.380,1.669,-0.289
5,1932,1525,407,1.556,1.229,0.328
5,1731,1729,2,1.394,1.393,0.002
5,1657,2130,-473,1.335,1.716,-0.381
5,1855,2158,-303,1.494,1.738,-0.244
5,1875,2070,-195,1.510,1.668,-0.157
5,1803,1980,-177,1.452,1.595,-0.143
5,2094,2337,-243,1.687,1.883,-0.196
5,2007,2016,-9,1.617,1.624,-0.007
5,2164,2106,58,1.743,1.697,0.047
5,1922,2380,-458,1.548,1.917,-0.369
5,1732,2087,-355,1.395,1.681,-0.286
5,2002,2033,-31,1.613,1.638,-0.025
5,1835,2035,-200,1.478,1.639,-0.161
5,1861,1988,-127,1.499,1.602,-0.102
5,2045,1774,271,1.647,1.429,0.218
5,1675,1922,-247,1.349,1.548,-0.199
5,1925,2030,-105,1.551,1.635,-0.085
5,1796,1892,-96,1.447,1.524,-0.077
5,1639,1927,-288,1.320,1.552,-0.232
5,1838,1710,128,1.481,1.378,0.103
5,1963,1984,-21,1.581,1.598,-0.017
5,1926,1551,375,1.552,1.249,0.302
5,2220,2239,-19,1.788,1.804,-0.015
5,2407,1766,641,1.939,1.423,0.516
5,1623,1590,33,1.307,1.281,0.027
5,1764,1831,-67,1.421,1.475,-0.054
5,1645,1804,-159,1.325,1.453,-0.128
5,2241,1679,562,1.805,1.353,0.453
5,2124,1563,561,1.711,1.259,0.452
5,1691,2111,-420,1.362,1.701,-0.338
5,1714,2334,-620,1.381,1.880,-0.499
5,1842,1821,21,1.484,1.467,0.017
5,2183,1767,416,1.759,1.423,0.335
5,1840,2351,-511,1.482,1.894,-0.412
5,1507,1768,-261,1.214,1.424,-0.210
5,2082,1920,162,1.677,1.547,0.131
5,1681,1525,156,1.354,1.229,0.126
5,1695,1798,-103,1.365,1.448,-0.083
5,1721,1711,10,1.386,1.378,0.008
5,1488,1635,-147,1.199,1.317,-0.118
5,2169,2361,-192,1.747,1.902,-0.155
5,2173,1758,415,1.751,1.416,0.334
5,2275,1748,527,1.833,1.408,0.425
5,2372,1784,588,1.911,1.437,0.474
5,2184,1588,596,1.759,1.279,0.480
5,1929,1875,54,1.554,1.510,0.044
5,1609,2109,-500,1.296,1.699,-0.403
5,1494,1996,-502,1.204,1.608,-0.404
5,1758,1946,-188,1.416,1.568,-0.151
5,2057,1624,433,1.657,1.308,0.349
5,2412,2074,338,1.943,1.671,0.272
5,1557,1754,-197,1.254,1.413,-0.159
5,2276,2299,-23,1.834,1.852,-0.019
5,1860,1930,-70,1.498,1.555,-0.056
5,2102,1518,584,1.693,1.223,0.470
5,1786,1917,-131,1.439,1.544,-0.106
5,2241,1714,527,1.805,1.381,0.425
5,2428,2104,324,1.956,1.695,0.261
5,1911,2089,-178,1.539,1.683,-0.143
5,2050,2023,27,1.651,1.630,0.022
5,2294,1511,783,1.848,1.217,0.631
5,2140,2022,118,1.724,1.629,0.095
5,1887,2275,-388,1.520,1.833,-0.313
5,2083,1871,212,1.678,1.507,0.171
5,1771,1701,70,1.427,1.370,0.056
5,2072,1595,477,1.669,1.285,0.384
5,2013,1915,98,1.622,1.543,0.079
5,2231,1964,267,1.797,1.582,0.215
5,2034,1777,257,1.639,1.432,0.207
5,1727,1877,-150,1.391,1.512,-0.121
5,1875,1821,54,1.510,1.467,0.044
5,1920,1865,55,1.547,1.502,0.044
5,1774,1676,98,1.429,1.350,0.079
5,2305,1779,526,1.857,1.433,0.424
5,1524,2078,-554,1.228,1.674,-0.446
5,1835,2172,-337,1.478,1.750,-0.271
5,1826,1915,-89,1.471,1.543,-0.072
5,1505,2205,-700,1.212,1.776,-0.564
5,1904,1792,112,1.534,1.444,0.090
5,1746,1835,-89,1.407,1.478,-0.072
5,2048,2284,-236,1.650,1.840,-0.190
5,1771,1707,64,1.427,1.375,0.052
5,2024,1942,82,1.631,1.564,0.066
5,2162,1784,378,1.742,1.437,0.305
5,2238,1987,251,1.803,1.601,0.202
5,2258,1721,537,1.819,1.386,0.433
5,1722,2200,-478,1.387,1.772,-0.385
5,2000,1682,318,1.611,1.355,0.256
5,1586,2221,-635,1.278,1.789,-0.512
5,2120,1929,191,1.708,1.554,0.154
5,2256,1724,532,1.817,1.389,0.429
5,2025,2261,-236,1.631,1.821,-0.190
5,2163,1980,183,1.742,1.595,0.147
5,2147,1917,230,1.730,1.544,0.185
5,1772,1948,-176,1.427,1.569,-0.142
5,2102,2183,-81,1.693,1.759,-0.065
5,1925,1855,70,1.551,1.494,0.056
5,2000,1878,122,1.611,1.513,0.098
5,1878,1654,224,1.513,1.332,0.180
5,2284,2191,93,1.840,1.765,0.075
5,1676,1813,-137,1.350,1.461,-0.110
5,1662,1846,-184,1.339,1.487,-0.148
5,1847,1726,121,1.488,1.390,0.097
5,1722,1654,68,1.387,1.332,0.055
5,2272,1743,529,1.830,1.404,0.426
5,2103,2089,14,1.694,1.683,0.011
5,1899,2077,-178,1.530,1.673,-0.143
5,1574,1663,-89,1.268,1.340,-0.072
5,2078,1954,124,1.674,1.574,0.100
5,2231,1711,520,1.797,1.378,0.419
5,1821,2369,-548,1.467,1.908,-0.441
5,1715,2314,-599,1.382,1.864,-0.483
5,1861,2310,-449,1.499,1.861,-0.362
5,2009,1984,25,1.618,1.598,0.020
5,2210,1931,279,1.780,1.556,0.225
5,1692,2199,-507,1.363,1.771,-0.408
5,1690,2028,-338,1.361,1.634,-0.272
5,1487,2048,-561,1.198,1.650,-0.452
5,1533,1519,14,1.235,1.224,0.011
5,1983,1972,11,1.597,1.589,0.009
5,2141,1551,590,1.725,1.249,0.475
5,2227,2194,33,1.794,1.767,0.027
5,1673,1962,-289,1.348,1.581,-0.233
5,2145,1936,209,1.728,1.560,0.168
5,2058,2102,-44,1.658,1.693,-0.035
5,2085,1890,195,1.680,1.523,0.157
5,1812,1759,53,1.460,1.417,0.043
5,1912,1970,-58,1.540,1.587,-0.047
5,2098,2187,-89,1.690,1.762,-0.072
5,2146,1735,411,1.729,1.398,0.331
5,1928,2183,-255,1.553,1.759,-0.205
5,2248,1830,418,1.811,1.474,0.337
5,1928,2132,-204,1.553,1.718,-0.164
5,1788,1885,-97,1.440,1.519,-0.078
5,2349,1874,475,1.892,1.510,0.383
5,2399,1661,738,1.933,1.338,0.595
5,1669,1502,167,1.345,1.210,0.135
5,1991,1729,262,1.604,1.393,0.211
5,1744,1883,-139,1.405,1.517,-0.112
5,1513,1916,-403,1.219,1.544,-0.325
5,2234,2164,70,1.800,1.743,0.056
5,2438,1641,797,1.964,1.322,0.642
5,2310,1879,431,1.861,1.514,0.347
5,1763,1582,181,1.420,1.274,0.146
5,2309,2328,-19,1.860,1.875,-0.015
5,1923,2194,-271,1.549,1.767,-0.218
5,1783,1815,-32,1.436,1.462,-0.026
5,1554,1574,-20,1.252,1.268,-0.016
5,1821,1497,324,1.467,1.206,0.261
5,1940,2133,-193,1.563,1.718,-0.155
5,1781,1494,287,1.435,1.204,0.231
5,2018,2147,-129,1.626,1.730,-0.104
5,2048,2066,-18,1.650,1.664,-0.015
5,2071,2041,30,1.668,1.644,0.024
5,2102,2341,-239,1.693,1.886,-0.193
5,1737,2128,-391,1.399,1.714,-0.315
5,2153,1784,369,1.734,1.437,0.297
5,2091,1661,430,1.684,1.338,0.346
5,2235,1707,528,1.800,1.375,0.425
5,2176,1814,362,1.753,1.461,0.292
5,1625,1711,-86,1.309,1.378,-0.069
5,1876,2182,-306,1.511,1.758,-0.247
5,2160,1485,675,1.740,1.196,0.544
5,2059,2349,-290,1.659,1.892,-0.234
5,1744,1796,-52,1.405,1.447,-0.042
5,1847,1944,-97,1.488,1.566,-0.078
5,1700,2136,-436,1.369,1.721,-0.351
5,2050,1731,319,1.651,1.394,0.257
5,2084,1605,479,1.679,1.293,0.386
5,2183,1647,536,1.759,1.327,0.432
5,1559,1758,-199,1.256,1.416,-0.160
5,2115,1903,212,1.704,1.533,0.171
5,1857,1937,-80,1.496,1.560,-0.064
5,1791,2083,-292,1.443,1.678,-0.235
5,2104,1619,485,1.695,1.304,0.391
5,1982,2169,-187,1.597,1.747,-0.151
5,1760,1540,220,1.418,1.241,0.177
5,1915,1845,70,1.543,1.486,0.056
5,2217,2037,180,1.786,1.641,0.145
5,1938,1734,204,1.561,1.397,0.164
5,1998,1931,67,1.610,1.556,0.054
5,1999,2177,-178,1.610,1.754,-0.143
5,2137,1877,260,1.722,1.512,0.209
5,1621,1665,-44,1.306,1.341,-0.035
5,2144,1623,521,1.727,1.307,0.420
5,2394,1503,891,1.929,1.211,0.718
5,1869,1685,184,1.506,1.357,0.148
5,2157,1532,625,1.738,1.234,0.503
5,1906,1795,111,1.535,1.446,0.089
5,1750,2025,-275,1.410,1.631,-0.222
5,1994,1883,111,1.606,1.517,0.089
5,1725,1567,158,1.390,1.262,0.127
5,2078,2060,18,1.674,1.660,0.015
5,2072,2161,-89,1.669,1.741,-0.072
5,1553,1992,-439,1.251,1.605,-0.354
5,2222,1740,482,1.790,1.402,0.388
5,1641,2030,-389,1.322,1.635,-0.313
5,2362,2118,244,1.903,1.706,0.197
5,1572,1661,-89,1.266,1.338,-0.072
5,2140,1661,479,1.724,1.338,0.386
5,1762,2040,-278,1.419,1.643,-0.224
5,1747,1890,-143,1.407,1.523,-0.115
5,1627,2073,-446,1.311,1.670,-0.359
5,2142,1716,426,1.726,1.382,0.343
5,1921,2149,-228,1.548,1.731,-0.184
5,1806,1838,-32,1.455,1.481,-0.026
5,1989,1831,158,1.602,1.475,0.127
5,2039,2018,21,1.643,1.626,0.017
5,1920,1707,213,1.547,1.375,0.172
5,1601,1835,-234,1.290,1.478,-0.189
5,1769,1795,-26,1.425,1.446,-0.021
5,1938,1523,415,1.561,1.227,0.334
5,1877,1807,70,1.512,1.456,0.056
5,1759,1857,-98,1.417,1.496,-0.079
5,1752,1741,11,1.411,1.403,0.009
5,1646,1632,14,1.326,1.315,0.011
5,1942,1692,250,1.564,1.363,0.201
5,1899,1973,-74,1.530,1.589,-0.060
5,1771,1709,62,1.427,1.377,0.050
5,2063,2241,-178,1.662,1.805,-0.143
5,1895,2283,-388,1.527,1.839,-0.313
5,2032,2111,-79,1.637,1.701,-0.064
5,1919,2049,-130,1.546,1.651,-0.105
5,1903,1587,316,1.533,1.278,0.255
5,1900,2225,-325,1.531,1.792,-0.262
5,2080,1922,158,1.676,1.548,0.127
5,1764,1594,170,1.421,1.284,0.137
5,2166,2135,31,1.745,1.720,0.025
5,1927,1605,322,1.552,1.293,0.259
5,2024,1695,329,1.631,1.365,0.265
5,2064,1986,78,1.663,1.600,0.063
5,2272,1985,287,1.830,1.599,0.231
5,2406,2166,240,1.938,1.745,0.193
5,1974,1707,267,1.590,1.375,0.215
5,2276,1900,376,1.834,1.531,0.303
5,1959,1743,216,1.578,1.404,0.174
5,1645,2133,-488,1.325,1.718,-0.393
5,2146,2134,12,1.729,1.719,0.010
5,1786,2181,-395,1.439,1.757,-0.318
5,2148,2177,-29,1.730,1.754,-0.023
5,2093,2024,69,1.686,1.631,0.056
5,1837,1514,323,1.480,1.220,0.260
5,1722,1757,-35,1.387,1.415,-0.028
5,1860,1992,-132,1.498,1.605,-0.106
5,1947,1584,363,1.568,1.276,0.292
5,1902,1840,62,1.532,1.482,0.050
5,2256,1566,690,1.817,1.262,0.556
5,2240,2114,126,1.805,1.703,0.102
5,2176,2057,119,1.753,1.657,0.096
5,1874,1915,-41,1.510,1.543,-0.033
5,1817,1699,118,1.464,1.369,0.095
5,1806,2180,-374,1.455,1.756,-0.301
5,1833,2222,-389,1.477,1.790,-0.313
5,1725,1967,-242,1.390,1.585,-0.195
5,1682,1972,-290,1.355,1.589,-0.234
5,2036,2381,-345,1.640,1.918,-0.278
5,1765,2217,-452,1.422,1.786,-0.364
5,1767,1866,-99,1.423,1.503,-0.080
5,1767,2316,-549,1.423,1.866,-0.442
5,1505,2161,-656,1.212,1.741,-0.528
5,2176,2371,-195,1.753,1.910,-0.157
5,1924,2317,-393,1.550,1.867,-0.317
5,2126,1867,259,1.713,1.504,0.209
5,2082,2067,15,1.677,1.665,0.012
5,2090,1883,207,1.684,1.517,0.167
5,2353,1920,433,1.896,1.547,0.349
5,1829,2062,-233,1.473,1.661,-0.188
5,2392,1867,525,1.927,1.504,0.423
5,1871,2162,-291,1.507,1.742,-0.234
5,2232,1804,428,1.798,1.453,0.345
5,2073,1851,222,1.670,1.491,0.179
5,1711,2058,-347,1.378,1.658,-0.280
5,1660,1853,-193,1.337,1.493,-0.155
5,1749,1804,-55,1.409,1.453,-0.044
5,1955,2102,-147,1.575,1.693,-0.118
5,2377,2089,288,1.915,1.683,0.232
5,2253,1619,634,1.815,1.304,0.511
5,2398,1771,627,1.932,1.427,0.505
5,1572,1879,-307,1.266,1.514,-0.247
5,1782,2022,-240,1.436,1.629,-0.193
5,2150,1935,215,1.732,1.559,0.173
5,1681,1918,-237,1.354,1.545,-0.191
5,2042,1980,62,1.645,1.595,0.050
5,1837,2022,-185,1.480,1.629,-0.149
5,1887,1831,56,1.520,1.475,0.045
5,2141,1917,224,1.725,1.544,0.180
5,2088,2076,12,1.682,1.672,0.010
5,2296,1467,829,1.850,1.182,0.668
5,2037,1966,71,1.641,1.584,0.057
5,2144,1666,478,1.727,1.342,0.385
5,1683,1673,10,1.356,1.348,0.008
5,2051,1680,371,1.652,1.353,0.299
5,1913,2167,-254,1.541,1.746,-0.205
5,1727,2128,-401,1.391,1.714,-0.323
5,1985,2109,-124,1.599,1.699,-0.100
5,1501,1593,-92,1.209,1.283,-0.074
5,2382,1998,384,1.919,1.610,0.309
5,1595,2089,-494,1.285,1.683,-0.398
5,2210,1843,367,1.780,1.485,0.296
5,1849,1786,63,1.490,1.439,0.051
5,1492,2193,-701,1.202,1.767,-0.565
5,2222,1858,364,1.790,1.497,0.293
5,2115,1939,176,1.704,1.562,0.142
5,1747,1687,60,1.407,1.359,0.048
5,2261,1974,287,1.821,1.590,0.231
5,1996,1784,212,1.608,1.437,0.171
5,1889,2016,-127,1.522,1.624,-0.102
5,2252,1935,317,1.814,1.559,0.255
5,1839,1683,156,1.481,1.356,0.126
5,2007,1681,326,1.617,1.354,0.263
5,1791,2339,-548,1.443,1.884,-0.441
5,1793,1899,-106,1.444,1.530,-0.085
5,1801,2202,-401,1.451,1.774,-0.323
5,2220,1944,276,1.788,1.566,0.222
5,1753,1691,62,1.412,1.362,0.050
5,1859,1587,272,1.498,1.278,0.219
5,2109,1933,176,1.699,1.557,0.142
5,1596,1906,-310,1.286,1.535,-0.250
5,2272,2049,223,1.830,1.651,0.180
5,2324,1692,632,1.872,1.363,0.509
5,1997,1774,223,1.609,1.429,0.180
5,2198,1666,532,1.771,1.342,0.429
5,1979,1871,108,1.594,1.507,0.087
5,1720,1875,-155,1.386,1.510,-0.125
5,1713,1706,7,1.380,1.374,0.006
5,1968,2016,-48,1.585,1.624,-0.039
5,1522,1921,-399,1.226,1.548,-0.321
5,1823,1705,118,1.469,1.374,0.095
5,1974,2382,-408,1.590,1.919,-0.329
5,2032,1912,120,1.637,1.540,0.097
5,1831,1457,374,1.475,1.174,0.301
5,2299,1665,634,1.852,1.341,0.511
5,2042,1723,319,1.645,1.388,0.257
5,1793,2194,-401,1.444,1.767,-0.323
5,1493,1494,-1,1.203,1.204,-0.001
5,1765,2374,-609,1.422,1.912,-0.491
5,2134,1718,416,1.719,1.384,0.335
5,1781,1570,211,1.435,1.265,0.170
5,1922,1617,305,1.548,1.303,0.246
5,1837,1882,-45,1.480,1.516,-0.036
5,1992,1881,111,1.605,1.515,0.089
5,1623,1665,-42,1.307,1.341,-0.034
5,1983,1661,322,1.597,1.338,0.259
5,2030,1869,161,1.635,1.506,0.130
5,1830,2223,-393,1.474,1.791,-0.317
5,2088,2177,-89,1.682,1.754,-0.072
5,2048,2235,-187,1.650,1.800,-0.151
5,2254,2292,-38,1.816,1.846,-0.031
5,1893,2138,-245,1.525,1.722,-0.197
5,2407,1915,492,1.939,1.543,0.396
5,1635,1677,-42,1.317,1.351,-0.034
5,2004,2298,-294,1.614,1.851,-0.237
5,2368,1788,580,1.908,1.440,0.467
5,1991,1886,105,1.604,1.519,0.085
5,1689,1836,-147,1.361,1.479,-0.118
5,1691,1887,-196,1.362,1.520,-0.158
5,2410,1719,691,1.941,1.385,0.557
5,1988,1727,261,1.602,1.391,0.210
5,1522,1720,-198,1.226,1.386,-0.160
5,1571,2126,-555,1.266,1.713,-0.447
5,2141,1966,175,1.725,1.584,0.141
5,2304,1760,544,1.856,1.418,0.438
5,1711,1864,-153,1.378,1.502,-0.123
5,1718,1660,58,1.384,1.337,0.047
5,1823,1809,14,1.469,1.457,0.011
5,2029,2014,15,1.635,1.622,0.012
5,2141,2334,-193,1.725,1.880,-0.155
5,2038,2126,-88,1.642,1.713,-0.071
5,2250,2338,-88,1.813,1.883,-0.071
5,2149,1892,257,1.731,1.524,0.207
5,1996,1741,255,1.608,1.403,0.205
5,2008,1902,106,1.618,1.532,0.085
5,1709,1848,-139,1.377,1.489,-0.112
5,1961,2310,-349,1.580,1.861,-0.281
5,2434,1537,897,1.961,1.238,0.723
5,1808,2186,-378,1.456,1.761,-0.305
5,2309,2130,179,1.860,1.716,0.144
5,1832,1781,51,1.476,1.435,0.041
5,1895,2080,-185,1.527,1.676,-0.149
5,2243,2012,231,1.807,1.621,0.186
5,1920,1822,98,1.547,1.468,0.079
5,2084,2067,17,1.679,1.665,0.014
5,1828,1711,117,1.473,1.378,0.094
5,1987,1676,311,1.601,1.350,0.251
5,2097,2144,-47,1.689,1.727,-0.038
5,1807,1708,99,1.456,1.376,0.080
5,2093,1974,119,1.686,1.590,0.096
5,1533,1781,-248,1.235,1.435,-0.200
5,1938,1781,157,1.561,1.435,0.126
5,2108,2032,76,1.698,1.637,0.061
5,1936,1777,159,1.560,1.432,0.128
5,2144,1963,181,1.727,1.581,0.146
5,1678,1722,-44,1.352,1.387,-0.035
5,1674,1915,-241,1.349,1.543,-0.194
5,2190,1879,311,1.764,1.514,0.251
5,1571,1821,-250,1.266,1.467,-0.201
5,2344,1872,472,1.888,1.508,0.380
5,2197,2019,178,1.770,1.626,0.143
5,2159,1978,181,1.739,1.593,0.146
5,2161,1895,266,1.741,1.527,0.214
5,1748,1891,-143,1.408,1.523,-0.115
5,2054,1791,263,1.655,1.443,0.212
5,1908,1758,150,1.537,1.416,0.121
5,1967,1593,374,1.585,1.283,0.301
5,2172,2148,24,1.750,1.730,0.019
5,2112,2354,-242,1.701,1.896,-0.195
5,1759,2000,-241,1.417,1.611,-0.194
5,1820,1873,-53,1.466,1.509,-0.043
5,2300,2182,118,1.853,1.758,0.095
5,1844,2186,-342,1.485,1.761,-0.276
5,1537,1926,-389,1.238,1.552,-0.313
,,,0,0.000,0.000,0.000
5,1831,1872,-41,1.475,1.508,-0.033
5,1779,1720,59,1.433,1.386,0.048
5,1727,2026,-299,1.391,1.632,-0.241
5,1982,1666,316,1.597,1.342,0.255
5,1921,1665,256,1.548,1.341,0.206
5,2338,1864,474,1.883,1.502,0.382
5,2126,1597,529,1.713,1.287,0.426
5,2134,1721,413,1.719,1.386,0.333
5,2141,1733,408,1.725,1.396,0.329
5,1587,2094,-507,1.278,1.687,-0.408
5,1759,1730,29,1.417,1.394,0.023
5,1548,2134,-586,1.247,1.719,-0.472
5,1506,1781,-275,1.213,1.435,-0.222
5,1864,1885,-21,1.502,1.519,-0.017
5,2220,2186,34,1.788,1.761,0.027
5,1724,1736,-12,1.389,1.398,-0.010
5,2027,2292,-265,1.633,1.846,-0.213
5,2026,1979,47,1.632,1.594,0.038
5,2283,1727,556,1.839,1.391,0.448
5,1708,1568,140,1.376,1.263,0.113
5,2019,1926,93,1.626,1.552,0.075
5,2022,1975,47,1.629,1.591,0.038
5,1766,1518,248,1.423,1.223,0.200
5,2222,2066,156,1.790,1.664,0.126
5,1695,2355,-660,1.365,1.897,-0.532
5,1800,1685,115,1.450,1.357,0.093
5,2005,1854,151,1.615,1.494,0.122
5,1716,1924,-208,1.382,1.550,-0.168
5,2331,2279,52,1.878,1.836,0.042
5,2204,2096,108,1.776,1.689,0.087
5,2242,1780,462,1.806,1.434,0.372
5,1936,1947,-11,1.560,1.568,-0.009
5,2025,1969,56,1.631,1.586,0.045
5,1999,1850,149,1.610,1.490,0.120
5,1503,1720,-217,1.211,1.386,-0.175
5,2364,1845,519,1.904,1.486,0.418
5,2278,1503,775,1.835,1.211,0.624
5,1732,2086,-354,1.395,1.680,-0.285
5,1909,2307,-398,1.538,1.858,-0.321
5,1562,1455,107,1.258,1.172,0.086
5,1980,1916,64,1.595,1.544,0.052
5,2198,2387,-189,1.771,1.923,-0.152
5,2158,1863,295,1.738,1.501,0.238
5,2204,2305,-101,1.776,1.857,-0.081
5,2030,2140,-110,1.635,1.724,-0.089
5,2078,1970,108,1.674,1.587,0.087
5,2057,1709,348,1.657,1.377,0.280
5,2098,1759,339,1.690,1.417,0.273
5,1998,1991,7,1.610,1.604,0.006
5,2190,1750,440,1.764,1.410,0.354
5,2024,1719,305,1.631,1.385,0.246
5,2188,1957,231,1.763,1.577,0.186
5,2336,1740,596,1.882,1.402,0.480
5,2058,1734,324,1.658,1.397,0.261
5,2038,1779,259,1.642,1.433,0.209
5,2100,1855,245,1.692,1.494,0.197
5,1922,1696,226,1.548,1.366,0.182
5,2241,1986,255,1.805,1.600,0.205
5,2087,1996,91,1.681,1.608,0.073
5,2039,1532,507,1.643,1.234,0.408
5,1706,1554,152,1.374,1.252,0.122
5,1741,1910,-169,1.403,1.539,-0.136
5,1614,1617,-3,1.300,1.303,-0.002
5,2096,2343,-247,1.689,1.887,-0.199
5,1854,2049,-195,1.494,1.651,-0.157
5,1668,2121,-453,1.344,1.709,-0.365
5,1725,2124,-399,1.390,1.711,-0.321
5,1737,2025,-288,1.399,1.631,-0.232
5,1724,1934,-210,1.389,1.558,-0.169
5,2104,2021,83,1.695,1.628,0.067
5,1617,1612,5,1.303,1.299,0.004
5,2026,1707,319,1.632,1.375,0.257
5,2077,1915,162,1.673,1.543,0.131
5,1970,2151,-181,1.587,1.733,-0.146
5,2362,2389,-27,1.903,1.925,-0.022
5,1923,2172,-249,1.549,1.750,-0.201
5,2176,1861,315,1.753,1.499,0.254
5,1980,1831,149,1.595,1.475,0.120
5,2224,1871,353,1.792,1.507,0.284
5,2426,1717,709,1.954,1.383,0.571
5,1529,2043,-514,1.232,1.646,-0.414
5,1621,1934,-313,1.306,1.558,-0.252
5,1723,2040,-317,1.388,1.643,-0.255
5,2187,2352,-165,1.762,1.895,-0.133
5,1563,1786,-223,1.259,1.439,-0.180
5,2177,1674,503,1.754,1.349,0.405
5,2116,2110,6,1.705,1.700,0.005
5,2195,1479,716,1.768,1.191,0.577
5,2025,2269,-244,1.631,1.828,-0.197
5,1841,1986,-145,1.483,1.600,-0.117
5,1921,1721,200,1.548,1.386,0.161
5,2399,1730,669,1.933,1.394,0.539
5,1903,2147,-244,1.533,1.730,-0.197
5,1908,2152,-244,1.537,1.734,-0.197
5,2017,2007,10,1.625,1.617,0.008
5,2190,1711,479,1.764,1.378,0.386
5,1760,2300,-540,1.418,1.853,-0.435
5,2309,1881,428,1.860,1.515,0.345
5,2028,2100,-72,1.634,1.692,-0.058
5,2309,2161,148,1.860,1.741,0.119
5,2061,1531,530,1.660,1.233,0.427
5,1834,1921,-87,1.477,1.548,-0.070
5,1857,2193,-336,1.496,1.767,-0.271
5,2158,1927,231,1.738,1.552,0.186
5,1682,1917,-235,1.355,1.544,-0.189
5,1518,2170,-652,1.223,1.748,-0.525
5,2125,1550,575,1.712,1.249,0.463
5,1858,2196,-338,1.497,1.769,-0.272
5,2105,1936,169,1.696,1.560,0.136
5,2151,2236,-85,1.733,1.801,-0.068
5,1691,1737,-46,1.362,1.399,-0.037
5,1532,1525,7,1.234,1.229,0.006
5,1633,1928,-295,1.316,1.553,-0.238
5,1787,2021,-234,1.440,1.628,-0.189
5,1920,1711,209,1.547,1.378,0.168
5,1869,2166,-297,1.506,1.745,-0.239
5,1831,1770,61,1.475,1.426,0.049
5,2096,1873,223,1.689,1.509,0.180
5,2399,1928,471,1.933,1.553,0.379
5,2244,1870,374,1.808,1.506,0.301
5,1823,1867,-44,1.469,1.504,-0.035
5,1830,2057,-227,1.474,1.657,-0.183
5,2009,1793,216,1.618,1.444,0.174
5,2200,2071,129,1.772,1.668,0.104
5,2136,1812,324,1.721,1.460,0.261
5,1759,2295,-536,1.417,1.849,-0.432
5,2206,1777,429,1.777,1.432,0.346
5,2096,1512,584,1.689,1.218,0.470
5,1518,1711,-193,1.223,1.378,-0.155
5,1662,1855,-193,1.339,1.494,-0.155
5,1750,2140,-390,1.410,1.724,-0.314
5,1800,1894,-94,1.450,1.526,-0.076
5,2058,2300,-242,1.658,1.853,-0.195
5,2222,1694,528,1.790,1.365,0.425
5,2172,1905,267,1.750,1.535,0.215
5,2327,1754,573,1.875,1.413,0.462
5,2232,2178,54,1.798,1.755,0.044
5,1886,2073,-187,1.519,1.670,-0.151
5,2040,2339,-299,1.643,1.884,-0.241
5,1944,1791,153,1.566,1.443,0.123
5,1848,2188,-340,1.489,1.763,-0.274
5,2052,1988,64,1.653,1.602,0.052
5,1810,2361,-551,1.458,1.902,-0.444
5,1599,1950,-351,1.288,1.571,-0.283
5,1604,2112,-508,1.292,1.701,-0.409
5,1977,2120,-143,1.593,1.708,-0.115
5,1831,1923,-92,1.475,1.549,-0.074
5,2034,1710,324,1.639,1.378,0.261
5,2090,1875,215,1.684,1.510,0.173
5,2136,2072,64,1.721,1.669,0.052
5,1731,1667,64,1.394,1.343,0.052
5,1724,1462,262,1.389,1.178,0.211
5,1999,1932,67,1.610,1.556,0.054
5,1847,1688,159,1.488,1.360,0.128
5,2268,1793,475,1.827,1.444,0.383
5,2264,1990,274,1.824,1.603,0.221
5,1754,1746,8,1.413,1.407,0.006
5,1700,1834,-134,1.369,1.477,-0.108
5,2098,1889,209,1.690,1.522,0.168
5,1900,1734,166,1.531,1.397,0.134
5,1936,1835,101,1.560,1.478,0.081
5,1734,1926,-192,1.397,1.552,-0.155
5,1839,2126,-287,1.481,1.713,-0.231
5,1620,1880,-260,1.305,1.515,-0.209
5,1573,2383,-810,1.267,1.920,-0.653
5,2185,2217,-32,1.760,1.786,-0.026
5,1975,1450,525,1.591,1.168,0.423
5,1663,1751,-88,1.340,1.411,-0.071
5,2434,2308,126,1.961,1.859,0.102
5,2016,2302,-286,1.624,1.854,-0.230
5,2274,2099,175,1.832,1.691,0.141
5,2120,1799,321,1.708,1.449,0.259
5,1751,2154,-403,1.411,1.735,-0.325
5,2329,1751,578,1.876,1.411,0.466
5,2127,2164,-37,1.713,1.743,-0.030
5,1824,1764,60,1.469,1.421,0.048
5,2028,1813,215,1.634,1.461,0.173
5,1494,2156,-662,1.204,1.737,-0.533
5,1862,1491,371,1.500,1.201,0.299
5,1603,2041,-438,1.291,1.644,-0.353
5,1753,1937,-184,1.412,1.560,-0.148
5,2166,1684,482,1.745,1.357,0.388
5,2093,2066,27,1.686,1.664,0.022
5,1921,2006,-85,1.548,1.616,-0.068
5,1555,1810,-255,1.253,1.458,-0.205
5,2020,1661,359,1.627,1.338,0.289
5,1673,1960,-287,1.348,1.579,-0.231
5,2129,2275,-146,1.715,1.833,-0.118
5,2346,1867,479,1.890,1.504,0.386
5,1777,2225,-448,1.432,1.792,-0.361
5,2348,2124,224,1.892,1.711,0.180
5,1987,1879,108,1.601,1.514,0.087
5,2188,2160,28,1.763,1.740,0.023
5,2341,1779,562,1.886,1.433,0.453
5,2148,1933,215,1.730,1.557,0.173
5,2426,1695,731,1.954,1.365,0.589
5,2068,1606,462,1.666,1.294,0.372
5,1821,2068,-247,1.467,1.666,-0.199
5,1683,2132,-449,1.356,1.718,-0.362
5,1928,2233,-305,1.553,1.799,-0.246
5,2416,1527,889,1.946,1.230,0.716
5,1600,1757,-157,1.289,1.415,-0.126
5,1989,1726,263,1.602,1.390,0.212
5,1996,2181,-185,1.608,1.757,-0.149
5,1535,1904,-369,1.237,1.534,-0.297
5,1863,1953,-90,1.501,1.573,-0.073
5,1919,1871,48,1.546,1.507,0.039
5,1881,1517,364,1.515,1.222,0.293
5,2156,1903,253,1.737,1.533,0.204
5,2073,2014,59,1.670,1.622,0.048
5,2104,1735,369,1.695,1.398,0.297
5,2021,1773,248,1.628,1.428,0.200
5,2041,2040,1,1.644,1.643,0.001
5,1554,2382,-828,1.252,1.919,-0.667
5,1792,1473,319,1.444,1.187,0.257
5,1949,2159,-210,1.570,1.739,-0.169
5,2025,2069,-44,1.631,1.667,-0.035
5,1933,1678,255,1.557,1.352,0.205
5,2206,2036,170,1.777,1.640,0.137
5,2154,2238,-84,1.735,1.803,-0.068
5,2160,2138,22,1.740,1.722,0.018
5,1852,2198,-346,1.492,1.771,-0.279
5,2168,2051,117,1.747,1.652,0.094
5,2283,1655,628,1.839,1.333,0.506
5,1767,1910,-143,1.423,1.539,-0.115
5,1766,1758,8,1.423,1.416,0.006
5,2138,2228,-90,1.722,1.795,-0.073
5,1993,2086,-93,1.606,1.680,-0.075
5,2217,1912,305,1.786,1.540,0.246
5,2192,2162,30,1.766,1.742,0.024
5,2128,2113,15,1.714,1.702,0.012
5,2244,2023,221,1.808,1.630,0.178
5,1679,1782,-103,1.353,1.436,-0.083
5,1730,2085,-355,1.394,1.680,-0.286
5,1533,1927,-394,1.235,1.552,-0.317
5,1745,1476,269,1.406,1.189,0.217
5,2106,2139,-33,1.697,1.723,-0.027
5,2261,2145,116,1.821,1.728,0.093
5,2230,1817,413,1.796,1.464,0.333
5,1881,2227,-346,1.515,1.794,-0.279
5,1890,2188,-298,1.523,1.763,-0.240
5,1906,1859,47,1.535,1.498,0.038
5,2432,1753,679,1.959,1.412,0.547
5,2391,1661,730,1.926,1.338,0.588
5,2300,1885,415,1.853,1.519,0.334
5,2155,2148,7,1.736,1.730,0.006
5,2122,1497,625,1.709,1.206,0.503
5,2083,1463,620,1.678,1.179,0.499
5,1887,2034,-147,1.520,1.639,-0.118
5,1957,1935,22,1.577,1.559,0.018
5,1857,1937,-80,1.496,1.560,-0.064
5,2169,1948,221,1.747,1.569,0.178
5,2181,1708,473,1.757,1.376,0.381
5,1966,2062,-96,1.584,1.661,-0.077
5,1871,1925,-54,1.507,1.551,-0.044
5,2400,1973,427,1.933,1.589,0.344
5,1896,1931,-35,1.527,1.556,-0.028
5,1539,1987,-448,1.240,1.601,-0.361
5,1850,1541,309,1.490,1.241,0.249
5,2026,1705,321,1.632,1.374,0.259
5,1834,1618,216,1.477,1.303,0.174
5,1841,1527,314,1.483,1.230,0.253
5,2154,1686,468,1.735,1.358,0.377
5,2211,1743,468,1.781,1.404,0.377
5,1701,2206,-505,1.370,1.777,-0.407
5,1913,2048,-135,1.541,1.650,-0.109
5,2330,1913,417,1.877,1.541,0.336
5,2023,1919,104,1.630,1.546,0.084
5,1880,1506,374,1.515,1.213,0.301
5,1920,1572,348,1.547,1.266,0.280
5,1793,1731,62,1.444,1.394,0.050
5,1582,1775,-193,1.274,1.430,-0.155
5,1784,1836,-52,1.437,1.479,-0.042
5,1945,2056,-111,1.567,1.656,-0.089
5,1570,1968,-398,1.265,1.585,-0.321
5,1785,2235,-450,1.438,1.800,-0.363
5,1995,1685,310,1.607,1.357,0.250
5,2048,1728,320,1.650,1.392,0.258
5,2356,2182,174,1.898,1.758,0.140
5,1788,2232,-444,1.440,1.798,-0.358
5,2048,2128,-80,1.650,1.714,-0.064
5,1730,1823,-93,1.394,1.469,-0.075
5,1675,2020,-345,1.349,1.627,-0.278
5,2144,1613,531,1.727,1.299,0.428
5,1825,2000,-175,1.470,1.611,-0.141
5,1669,1570,99,1.345,1.265,0.080
5,2150,2082,68,1.732,1.677,0.055
5,2107,2144,-37,1.697,1.727,-0.030
5,2224,1547,677,1.792,1.246,0.545
5,1922,2062,-140,1.548,1.661,-0.113
5,1765,2005,-240,1.422,1.615,-0.193
5,1571,2224,-653,1.266,1.792,-0.526
5,2189,1829,360,1.763,1.473,0.290
5,2090,1670,420,1.684,1.345,0.338
5,2201,1777,424,1.773,1.432,0.342
5,1741,1463,278,1.403,1.179,0.224
5,2104,1532,572,1.695,1.234,0.461
5,2058,2352,-294,1.658,1.895,-0.237
5,1857,1486,371,1.496,1.197,0.299
5,1878,2227,-349,1.513,1.794,-0.281
5,1831,2021,-190,1.475,1.628,-0.153
5,1740,1890,-150,1.402,1.523,-0.121
5,2262,2239,23,1.822,1.804,0.019
5,2103,1630,473,1.694,1.313,0.381
5,2164,1904,260,1.743,1.534,0.209
5,2278,2111,167,1.835,1.701,0.135
5,2087,1972,115,1.681,1.589,0.093
5,1731,1918,-187,1.394,1.545,-0.151
5,2150,2229,-79,1.732,1.796,-0.064
5,1989,1515,474,1.602,1.220,0.382
5,1749,2193,-444,1.409,1.767,-0.358
5,1864,1765,99,1.502,1.422,0.080
5,1568,1922,-354,1.263,1.548,-0.285
5,1823,1711,112,1.469,1.378,0.090
5,2126,2213,-87,1.713,1.783,-0.070
5,2136,2109,27,1.721,1.699,0.022
5,2025,1917,108,1.631,1.544,0.087
5,1811,2157,-346,1.459,1.738,-0.279
5,1818,1495,323,1.465,1.204,0.260
5,1878,1726,152,1.513,1.390,0.122
5,2304,2137,167,1.856,1.722,0.135
5,2266,1944,322,1.825,1.566,0.259
5,2422,1899,523,1.951,1.530,0.421
5,1693,1848,-155,1.364,1.489,-0.125
5,1704,1811,-107,1.373,1.459,-0.086
5,2131,1607,524,1.717,1.295,0.422
5,1823,2024,-201,1.469,1.631,-0.162
5,1686,2386,-700,1.358,1.922,-0.564
5,1738,1578,160,1.400,1.271,0.129
5,2202,1782,420,1.774,1.436,0.338
5,1903,2300,-397,1.533,1.853,-0.320
5,1702,1499,203,1.371,1.208,0.164
5,2027,2176,-149,1.633,1.753,-0.120
5,2136,2176,-40,1.721,1.753,-0.032
5,1525,2029,-504,1.229,1.635,-0.406
5,2113,1931,182,1.702,1.556,0.147
5,2005,2086,-81,1.615,1.680,-0.065
5,2051,2360,-309,1.652,1.901,-0.249
5,1766,2010,-244,1.423,1.619,-0.197
5,1719,2006,-287,1.385,1.616,-0.231
5,1924,1819,105,1.550,1.465,0.085
5,2344,2014,330,1.888,1.622,0.266
5,2030,1958,72,1.635,1.577,0.058
5,2088,2158,-70,1.682,1.738,-0.056
5,1711,2004,-293,1.378,1.614,-0.236
5,2130,1602,528,1.716,1.291,0.425
5,1654,2156,-502,1.332,1.737,-0.404
5,1972,1707,265,1.589,1.375,0.213
5,2142,1777,365,1.726,1.432,0.294
5,2257,1891,366,1.818,1.523,0.295
5,2054,1852,202,1.655,1.492,0.163
5,2328,2007,321,1.875,1.617,0.259
5,2039,2029,10,1.643,1.635,0.008
5,2270,2000,270,1.829,1.611,0.218
5,1811,1863,-52,1.459,1.501,-0.042
5,1914,1770,144,1.542,1.426,0.116
5,1779,1923,-144,1.433,1.549,-0.116
5,2296,2389,-93,1.850,1.925,-0.075
5,1683,1684,-1,1.356,1.357,-0.001
5,1848,2300,-452,1.489,1.853,-0.364
5,2015,1900,115,1.623,1.531,0.093
5,1853,1586,267,1.493,1.278,0.215
5,1848,1927,-79,1.489,1.552,-0.064
5,1855,2251,-396,1.494,1.813,-0.319
5,2061,2048,13,1.660,1.650,0.010
5,1753,1911,-158,1.412,1.539,-0.127
5,1919,2369,-450,1.546,1.908,-0.363
5,1659,1764,-105,1.336,1.421,-0.085
5,1877,1713,164,1.512,1.380,0.132
5,2250,1833,417,1.813,1.477,0.336
5,2366,2314,52,1.906,1.864,0.042
5,2077,2376,-299,1.673,1.914,-0.241
5,2245,1565,680,1.809,1.261,0.548
5,2155,2086,69,1.736,1.680,0.056
5,2164,1987,177,1.743,1.601,0.143
5,2209,1988,221,1.780,1.602,0.178
5,2108,2140,-32,1.698,1.724,-0.026
5,2113,1535,578,1.702,1.237,0.466
5,2216,1688,528,1.785,1.360,0.425
5,1591,1853,-262,1.282,1.493,-0.211
5,2434,2213,221,1.961,1.783,0.178
5,1921,2069,-148,1.548,1.667,-0.119
5,2402,1980,422,1.935,1.595,0.340
5,2426,1683,743,1.954,1.356,0.599
5,1802,2093,-291,1.452,1.686,-0.234
5,1867,2168,-301,1.504,1.747,-0.242
5,1670,1875,-205,1.345,1.510,-0.165
5,1724,1923,-199,1.389,1.549,-0.160
5,1842,1895,-53,1.484,1.527,-0.043
5,2072,1809,263,1.669,1.457,0.212
5,1813,1707,106,1.461,1.375,0.085
5,2139,2170,-31,1.723,1.748,-0.025
5,1729,2181,-452,1.393,1.757,-0.364
5,1940,2152,-212,1.563,1.734,-0.171
5,1654,1656,-2,1.332,1.334,-0.002
5,2244,1933,311,1.808,1.557,0.251
5,1998,1730,268,1.610,1.394,0.216
5,2158,1932,226,1.738,1.556,0.182
5,2267,2043,224,1.826,1.646,0.180
5,1599,1545,54,1.288,1.245,0.044
5,1918,2058,-140,1.545,1.658,-0.113
5,1663,2216,-553,1.340,1.785,-0.445
5,1923,1827,96,1.549,1.472,0.077
5,2206,2083,123,1.777,1.678,0.099
5,2051,1668,383,1.652,1.344,0.309
5,1782,1977,-195,1.436,1.593,-0.157
5,2002,1795,207,1.613,1.446,0.167
5,1917,1865,52,1.544,1.502,0.042
5,1559,1919,-360,1.256,1.546,-0.290
5,1979,2063,-84,1.594,1.662,-0.068
5,2246,2182,64,1.809,1.758,0.052
5,2004,1738,266,1.614,1.400,0.214
5,1802,1899,-97,1.452,1.530,-0.078
5,1750,2163,-413,1.410,1.742,-0.333
5,1719,2176,-457,1.385,1.753,-0.368
5,1518,2137,-619,1.223,1.722,-0.499
5,1795,2091,-296,1.446,1.684,-0.238
5,1496,1709,-213,1.205,1.377,-0.172
5,1567,2236,-669,1.262,1.801,-0.539
5,1897,1794,103,1.528,1.445,0.083
5,1711,2172,-461,1.378,1.750,-0.371
5,1843,1530,313,1.485,1.233,0.252
5,2113,1994,119,1.702,1.606,0.096
5,2178,1723,455,1.755,1.388,0.367
5,2172,1885,287,1.750,1.519,0.231
5,1713,2197,-484,1.380,1.770,-0.390
5,1723,1681,42,1.388,1.354,0.034
5,1960,2216,-256,1.579,1.785,-0.206
5,1692,1964,-272,1.363,1.582,-0.219
5,2258,2058,200,1.819,1.658,0.161
5,2409,2102,307,1.941,1.693,0.247
5,1662,2236,-574,1.339,1.801,-0.462
5,2177,2131,46,1.754,1.717,0.037
5,1952,1670,282,1.573,1.345,0.227
5,1596,2172,-576,1.286,1.750,-0.464
5,2108,1865,243,1.698,1.502,0.196
5,2087,2140,-53,1.681,1.724,-0.043
5,1807,1945,-138,1.456,1.567,-0.111
5,1976,2224,-248,1.592,1.792,-0.200
5,1991,2246,-255,1.604,1.809,-0.205
5,1969,2120,-151,1.586,1.708,-0.122
5,1528,1845,-317,1.231,1.486,-0.255
5,1708,2120,-412,1.376,1.708,-0.332
5,1689,1757,-68,1.361,1.415,-0.055
5,1732,1783,-51,1.395,1.436,-0.041
5,2276,1984,292,1.834,1.598,0.235
5,2186,1789,397,1.761,1.441,0.320
5,1815,1879,-64,1.462,1.514,-0.052
5,2072,1615,457,1.669,1.301,0.368
5,1689,1533,156,1.361,1.235,0.126
5,2066,1602,464,1.664,1.291,0.374
5,2026,1914,112,1.632,1.542,0.090
5,2190,1967,223,1.764,1.585,0.180
5,2245,1920,325,1.809,1.547,0.262
5,2204,2179,25,1.776,1.755,0.020
5,1882,1670,212,1.516,1.345,0.171
5,2209,2305,-96,1.780,1.857,-0.077
5,1915,1964,-49,1.543,1.582,-0.039
5,1784,1895,-111,1.437,1.527,-0.089
5,2006,2299,-293,1.616,1.852,-0.236
5,2160,1691,469,1.740,1.362,0.378
5,2212,1988,224,1.782,1.602,0.180
5,1543,1901,-358,1.243,1.531,-0.288
5,2276,1947,329,1.834,1.568,0.265
5,2225,2099,126,1.792,1.691,0.102
5,2184,1865,319,1.759,1.502,0.257
5,1926,1809,117,1.552,1.457,0.094
5,1864,2209,-345,1.502,1.780,-0.278
5,1863,2160,-297,1.501,1.740,-0.239
5,1914,2111,-197,1.542,1.701,-0.159
5,2280,2052,228,1.837,1.653,0.184
5,2436,1851,585,1.962,1.491,0.471
5,2277,1897,380,1.834,1.528,0.306
5,1798,1842,-44,1.448,1.484,-0.035
5,2208,1831,377,1.779,1.475,0.304
5,2037,1924,113,1.641,1.550,0.091
5,2252,1457,795,1.814,1.174,0.640
5,1810,1703,107,1.458,1.372,0.086
5,2067,1700,367,1.665,1.369,0.296
5,1753,2351,-598,1.412,1.894,-0.482
5,2002,1786,216,1.613,1.439,0.174
5,1791,2032,-241,1.443,1.637,-0.194
5,2148,1726,422,1.730,1.390,0.340
5,2094,2389,-295,1.687,1.925,-0.238
5,1727,1503,224,1.391,1.211,0.180
5,2236,1819,417,1.801,1.465,0.336
5,2039,1918,121,1.643,1.545,0.097
5,1627,1462,165,1.311,1.178,0.133
,,,0,0.000,0.000,0.000
5,1776,1813,-37,1.431,1.461,-0.030
5,1912,2036,-124,1.540,1.640,-0.100
5,1842,2123,-281,1.484,1.710,-0.226
5,1765,1759,6,1.422,1.417,0.005
5,1561,1957,-396,1.258,1.577,-0.319
5,1867,1915,-48,1.504,1.543,-0.039
5,2232,1495,737,1.798,1.204,0.594
5,2019,2048,-29,1.626,1.650,-0.023
5,1917,2097,-180,1.544,1.689,-0.145
5,1851,2042,-191,1.491,1.645,-0.154
5,2052,1631,421,1.653,1.314,0.339
5,2052,2073,-21,1.653,1.670,-0.017
5,1913,2103,-190,1.541,1.694,-0.153
5,2016,2263,-247,1.624,1.823,-0.199
5,1507,1648,-141,1.214,1.328,-0.114
5,2169,2043,126,1.747,1.646,0.102
5,1964,2048,-84,1.582,1.650,-0.068
5,1756,2298,-542,1.415,1.851,-0.437
5,2154,1971,183,1.735,1.588,0.147
5,1617,1557,60,1.303,1.254,0.048
5,2125,1993,132,1.712,1.606,0.106
5,1859,2201,-342,1.498,1.773,-0.276
5,2070,2146,-76,1.668,1.729,-0.061
5,2275,1929,346,1.833,1.554,0.279
5,2110,2087,23,1.700,1.681,0.019
5,1796,1932,-136,1.447,1.556,-0.110
5,2158,2036,122,1.738,1.640,0.098
5,2261,1927,334,1.821,1.552,0.269
5,1843,1925,-82,1.485,1.551,-0.066
5,1892,2184,-292,1.524,1.759,-0.235
5,1736,1676,60,1.398,1.350,0.048
5,1994,1891,103,1.606,1.523,0.083
5,2416,1633,783,1.946,1.316,0.631
5,2108,2087,21,1.698,1.681,0.017
5,2048,1471,577,1.650,1.185,0.465
5,2406,1782,624,1.938,1.436,0.503
5,1783,1783,0,1.436,1.436,0.000
5,1795,2178,-383,1.446,1.755,-0.309
5,1782,1513,269,1.436,1.219,0.217
5,1837,2386,-549,1.480,1.922,-0.442
5,2032,2128,-96,1.637,1.714,-0.077
5,2032,1872,160,1.637,1.508,0.129
5,1926,2125,-199,1.552,1.712,-0.160
5,2198,1519,679,1.771,1.224,0.547
5,2108,1844,264,1.698,1.485,0.213
5,2218,1903,315,1.787,1.533,0.254
5,1964,1702,262,1.582,1.371,0.211
5,1967,1760,207,1.585,1.418,0.167
5,2088,2178,-90,1.682,1.755,-0.073
5,2357,1887,470,1.899,1.520,0.379
5,2001,1846,155,1.612,1.487,0.125
5,2063,1496,567,1.662,1.205,0.457
5,2025,2165,-140,1.631,1.744,-0.113
5,1675,2088,-413,1.349,1.682,-0.333
5,1803,1860,-57,1.452,1.498,-0.046
5,1725,2128,-403,1.390,1.714,-0.325
5,1583,2190,-607,1.275,1.764,-0.489
5,1850,2204,-354,1.490,1.776,-0.285
5,2126,1503,623,1.713,1.211,0.502
5,1986,1893,93,1.600,1.525,0.075
5,1713,2271,-558,1.380,1.829,-0.450
5,1726,1778,-52,1.390,1.432,-0.042
5,2162,1787,375,1.742,1.440,0.302
5,1902,1578,324,1.532,1.271,0.261
5,1807,2056,-249,1.456,1.656,-0.201
5,1918,1452,466,1.545,1.170,0.375
5,1731,1458,273,1.394,1.175,0.220
5,1639,2304,-665,1.320,1.856,-0.536
5,2070,1702,368,1.668,1.371,0.296
5,2123,1768,355,1.710,1.424,0.286
5,1514,1673,-159,1.220,1.348,-0.128
5,1743,1475,268,1.404,1.188,0.216
5,1805,1998,-193,1.454,1.610,-0.155
5,1771,1874,-103,1.427,1.510,-0.083
5,2247,1978,269,1.810,1.593,0.217
5,1793,2236,-443,1.444,1.801,-0.357
5,2258,2036,222,1.819,1.640,0.179
5,1694,2140,-446,1.365,1.724,-0.359
5,1909,2253,-344,1.538,1.815,-0.277
5,2176,2008,168,1.753,1.618,0.135
5,2138,1772,366,1.722,1.427,0.295
5,2096,1737,359,1.689,1.399,0.289
5,1594,2041,-447,1.284,1.644,-0.360
5,2172,2144,28,1.750,1.727,0.023
5,1750,1693,57,1.410,1.364,0.046
5,1484,2354,-870,1.195,1.896,-0.701
5,1698,1787,-89,1.368,1.440,-0.072
5,1798,1979,-181,1.448,1.594,-0.146
5,1787,2080,-293,1.440,1.676,-0.236
5,1932,1971,-39,1.556,1.588,-0.031
5,2246,1767,479,1.809,1.423,0.386
5,1781,2227,-446,1.435,1.794,-0.359
5,1891,2234,-343,1.523,1.800,-0.276
5,2412,1894,518,1.943,1.526,0.417
5,1744,2030,-286,1.405,1.635,-0.230
5,2107,1977,130,1.697,1.593,0.105
5,2052,1578,474,1.653,1.271,0.382
5,2112,1782,330,1.701,1.436,0.266
5,1785,2332,-547,1.438,1.879,-0.441
5,2195,2024,171,1.768,1.631,0.138
5,1918,2108,-190,1.545,1.698,-0.153
5,2389,2009,380,1.925,1.618,0.306
5,2243,1857,386,1.807,1.496,0.311
5,2279,1868,411,1.836,1.505,0.331
5,2393,1772,621,1.928,1.427,0.500
5,1570,1974,-404,1.265,1.590,-0.325
5,1980,2014,-34,1.595,1.622,-0.027
5,1865,1993,-128,1.502,1.606,-0.103
5,1695,1537,158,1.365,1.238,0.127
5,2053,2139,-86,1.654,1.723,-0.069
5,2206,2091,115,1.777,1.684,0.093
5,2166,2038,128,1.745,1.642,0.103
5,2011,1533,478,1.620,1.235,0.385
5,1746,2039,-293,1.407,1.643,-0.236
5,2105,1475,630,1.696,1.188,0.508
5,1992,1785,207,1.605,1.438,0.167
5,1520,1769,-249,1.224,1.425,-0.201
5,2088,1662,426,1.682,1.339,0.343
5,1775,1922,-147,1.430,1.548,-0.118
5,1912,1806,106,1.540,1.455,0.085
5,1966,1943,23,1.584,1.565,0.019
5,2065,2041,24,1.664,1.644,0.019
5,2364,1471,893,1.904,1.185,0.719
5,2300,2024,276,1.853,1.631,0.222
5,1576,1725,-149,1.270,1.390,-0.120
5,2398,2232,166,1.932,1.798,0.134
5,1921,1675,246,1.548,1.349,0.198
5,2300,1879,421,1.853,1.514,0.339
5,2144,2017,127,1.727,1.625,0.102
5,2136,2067,69,1.721,1.665,0.056
5,2122,1986,136,1.709,1.600,0.110
5,2059,1786,273,1.659,1.439,0.220
5,1838,1569,269,1.481,1.264,0.217
5,2140,1815,325,1.724,1.462,0.262
5,1561,1947,-386,1.258,1.568,-0.311
5,1952,2256,-304,1.573,1.817,-0.245
5,2221,2096,125,1.789,1.689,0.101
5,2001,1516,485,1.612,1.221,0.391
5,2044,1976,68,1.647,1.592,0.055
5,2244,1954,290,1.808,1.574,0.234
5,2386,1866,520,1.922,1.503,0.419
5,1971,2161,-190,1.588,1.741,-0.153
5,1917,1885,32,1.544,1.519,0.026
5,1619,1770,-151,1.304,1.426,-0.122
5,1913,2213,-300,1.541,1.783,-0.242
5,2025,1917,108,1.631,1.544,0.087
5,1964,1759,205,1.582,1.417,0.165
5,1766,2159,-393,1.423,1.739,-0.317
5,2279,1941,338,1.836,1.564,0.272
5,1593,1535,58,1.283,1.237,0.047
5,2166,1691,475,1.745,1.362,0.383
5,2384,2306,78,1.921,1.858,0.063
5,2376,1640,736,1.914,1.321,0.593
5,2003,1831,172,1.614,1.475,0.139
5,2144,1828,316,1.727,1.473,0.255
5,2137,1919,218,1.722,1.546,0.176
5,1717,2050,-333,1.383,1.651,-0.268
5,1751,1578,173,1.411,1.271,0.139
5,1521,1502,19,1.225,1.210,0.015
5,2280,2057,223,1.837,1.657,0.180
5,1953,1694,259,1.573,1.365,0.209
5,2110,1693,417,1.700,1.364,0.336
5,1697,2032,-335,1.367,1.637,-0.270
5,1897,1748,149,1.528,1.408,0.120
5,2330,2208,122,1.877,1.779,0.098
5,1916,2049,-133,1.544,1.651,-0.107
5,1855,2193,-338,1.494,1.767,-0.272
5,2220,1703,517,1.788,1.372,0.416
5,2120,1932,188,1.708,1.556,0.151
5,2421,2191,230,1.950,1.765,0.185
5,1791,2133,-342,1.443,1.718,-0.276
5,2202,2023,179,1.774,1.630,0.144
5,1671,1759,-88,1.346,1.417,-0.071
5,2173,1945,228,1.751,1.567,0.184
5,1908,1633,275,1.537,1.316,0.222
5,2154,1920,234,1.735,1.547,0.189
5,2246,2011,235,1.809,1.620,0.189
5,1564,1663,-99,1.260,1.340,-0.080
5,2023,1811,212,1.630,1.459,0.171
5,1502,1695,-193,1.210,1.365,-0.155
5,1551,1801,-250,1.249,1.451,-0.201
5,2381,2201,180,1.918,1.773,0.145
5,1706,2098,-392,1.374,1.690,-0.316
5,1708,2050,-342,1.376,1.651,-0.276
5,1763,1952,-189,1.420,1.573,-0.152
5,1610,1703,-93,1.297,1.372,-0.075
5,2176,1597,579,1.753,1.287,0.466
5,1813,1945,-132,1.461,1.567,-0.106
5,1919,2317,-398,1.546,1.867,-0.321
5,1764,1997,-233,1.421,1.609,-0.188
5,1855,1691,164,1.494,1.362,0.132
5,1490,1831,-341,1.200,1.475,-0.275
5,1576,2280,-704,1.270,1.837,-0.567
5,1916,2224,-308,1.544,1.792,-0.248
5,2087,1923,164,1.681,1.549,0.132
5,1863,1993,-130,1.501,1.606,-0.105
5,2258,2386,-128,1.819,1.922,-0.103
5,2144,2166,-22,1.727,1.745,-0.018
5,2021,2200,-179,1.628,1.772,-0.144
5,1847,1739,108,1.488,1.401,0.087
5,1498,1908,-410,1.207,1.537,-0.330
5,2229,1655,574,1.796,1.333,0.462
5,1873,2371,-498,1.509,1.910,-0.401
5,1816,2054,-238,1.463,1.655,-0.192
5,2216,1930,286,1.785,1.555,0.230
5,1990,2282,-292,1.603,1.838,-0.235
5,1877,2222,-345,1.512,1.790,-0.278
5,2022,1855,167,1.629,1.494,0.135
5,1946,1850,96,1.568,1.490,0.077
5,2124,1994,130,1.711,1.606,0.105
5,1751,1851,-100,1.411,1.491,-0.081
5,1949,2243,-294,1.570,1.807,-0.237
5,1841,1891,-50,1.483,1.523,-0.040
5,1731,2120,-389,1.394,1.708,-0.313
5,2084,2262,-178,1.679,1.822,-0.143
5,2422,1682,740,1.951,1.355,0.596
5,2319,1995,324,1.868,1.607,0.261
5,2176,2103,73,1.753,1.694,0.059
5,1756,1743,13,1.415,1.404,0.010
5,2373,1939,434,1.912,1.562,0.350
5,2163,1739,424,1.742,1.401,0.342
5,2218,2093,125,1.787,1.686,0.101
5,1749,1838,-89,1.409,1.481,-0.072
5,1834,1664,170,1.477,1.340,0.137
5,2134,2012,122,1.719,1.621,0.098
5,2238,1667,571,1.803,1.343,0.460
5,2249,1667,582,1.812,1.343,0.469
5,1569,1456,113,1.264,1.173,0.091
5,2349,1774,575,1.892,1.429,0.463
5,1670,1809,-139,1.345,1.457,-0.112
5,2131,1604,527,1.717,1.292,0.425
5,1711,1907,-196,1.378,1.536,-0.158
5,2273,1692,581,1.831,1.363,0.468
5,2164,1735,429,1.743,1.398,0.346
5,2003,2291,-288,1.614,1.846,-0.232
5,1735,1519,216,1.398,1.224,0.174
5,2202,1886,316,1.774,1.519,0.255
5,2048,1884,164,1.650,1.518,0.132
5,2155,1734,421,1.736,1.397,0.339
5,1895,1819,76,1.527,1.465,0.061
5,2347,2120,227,1.891,1.708,0.183
5,1983,1568,415,1.597,1.263,0.334
5,2156,1631,525,1.737,1.314,0.423
5,2266,1998,268,1.825,1.610,0.216
5,1706,1597,109,1.374,1.287,0.088
5,2029,1914,115,1.635,1.542,0.093
5,1869,2097,-228,1.506,1.689,-0.184
5,2170,2146,24,1.748,1.729,0.019
5,1859,1793,66,1.498,1.444,0.053
5,2113,1931,182,1.702,1.556,0.147
5,1643,2238,-595,1.324,1.803,-0.479
5,1986,2234,-248,1.600,1.800,-0.200
5,2147,1790,357,1.730,1.442,0.288
5,1899,1672,227,1.530,1.347,0.183
5,1888,1518,370,1.521,1.223,0.298
5,2256,2033,223,1.817,1.638,0.180
5,2414,2030,384,1.945,1.635,0.309
5,1740,1678,62,1.402,1.352,0.050
5,1784,2324,-540,1.437,1.872,-0.435
5,1709,2235,-526,1.377,1.800,-0.424
5,1920,2230,-310,1.547,1.796,-0.250
5,2196,1879,317,1.769,1.514,0.255
5,2193,1619,574,1.767,1.304,0.462
5,1735,1923,-188,1.398,1.549,-0.151
5,1715,1755,-40,1.382,1.414,-0.032
5,2218,1946,272,1.787,1.568,0.219
5,1679,1928,-249,1.353,1.553,-0.201
5,1989,1814,175,1.602,1.461,0.141
5,2128,2266,-138,1.714,1.825,-0.111
5,1977,2005,-28,1.593,1.615,-0.023
5,2074,2146,-72,1.671,1.729,-0.058
5,2098,2184,-86,1.690,1.759,-0.069
5,2360,2392,-32,1.901,1.927,-0.026
5,1890,2128,-238,1.523,1.714,-0.192
5,1924,1827,97,1.550,1.472,0.078
5,1839,2032,-193,1.481,1.637,-0.155
5,1644,2201,-557,1.324,1.773,-0.449
5,1964,2160,-196,1.582,1.740,-0.158
5,2027,1605,422,1.633,1.293,0.340
5,2077,1867,210,1.673,1.504,0.169
5,2087,1934,153,1.681,1.558,0.123
5,1982,1883,99,1.597,1.517,0.080
5,1843,2135,-292,1.485,1.720,-0.235
5,1795,1791,4,1.446,1.443,0.003
5,2164,1692,472,1.743,1.363,0.380
5,1954,2048,-94,1.574,1.650,-0.076
5,1705,1916,-211,1.374,1.544,-0.170
5,1788,1472,316,1.440,1.186,0.255
5,1803,1702,101,1.452,1.371,0.081
5,2126,1927,199,1.713,1.552,0.160
5,1923,1524,399,1.549,1.228,0.321
5,1956,2151,-195,1.576,1.733,-0.157
5,2329,1609,720,1.876,1.296,0.580
5,1518,1682,-164,1.223,1.355,-0.132
5,2222,1721,501,1.790,1.386,0.404
5,2043,2088,-45,1.646,1.682,-0.036
5,1761,1512,249,1.419,1.218,0.201
5,1923,1934,-11,1.549,1.558,-0.009
5,1850,2099,-249,1.490,1.691,-0.201
5,2120,1814,306,1.708,1.461,0.247
5,1567,1825,-258,1.262,1.470,-0.208
5,1525,2184,-659,1.229,1.759,-0.531
5,2212,1680,532,1.782,1.353,0.429
5,1999,1686,313,1.610,1.358,0.252
5,1944,1587,357,1.566,1.278,0.288
5,2123,2264,-141,1.710,1.824,-0.114
5,1976,1926,50,1.592,1.552,0.040
5,2356,1986,370,1.898,1.600,0.298
5,1913,2211,-298,1.541,1.781,-0.240
5,2132,1928,204,1.718,1.553,0.164
5,2202,2136,66,1.774,1.721,0.053
5,1685,1776,-91,1.357,1.431,-0.073
5,1984,1775,209,1.598,1.430,0.168
5,2092,2237,-145,1.685,1.802,-0.117
5,2005,1746,259,1.615,1.407,0.209
5,2180,1769,411,1.756,1.425,0.331
5,1767,1717,50,1.423,1.383,0.040
5,1986,2124,-138,1.600,1.711,-0.111
5,1742,1688,54,1.403,1.360,0.044
5,2110,1853,257,1.700,1.493,0.207
5,2334,1859,475,1.880,1.498,0.383
5,1916,1918,-2,1.544,1.545,-0.002
5,2264,1954,310,1.824,1.574,0.250
5,2080,2132,-52,1.676,1.718,-0.042
5,2260,1747,513,1.821,1.407,0.413
5,2079,1931,148,1.675,1.556,0.119
5,1580,1899,-319,1.273,1.530,-0.257
5,2428,1538,890,1.956,1.239,0.717
5,2189,1619,570,1.763,1.304,0.459
5,1799,1747,52,1.449,1.407,0.042
5,1819,1776,43,1.465,1.431,0.035
5,2204,2147,57,1.776,1.730,0.046
5,1970,2272,-302,1.587,1.830,-0.243
5,2200,2196,4,1.772,1.769,0.003
5,1922,1770,152,1.548,1.426,0.122
5,1897,2096,-199,1.528,1.689,-0.160
5,1970,1833,137,1.587,1.477,0.110
5,1747,2004,-257,1.407,1.614,-0.207
5,1974,2074,-100,1.590,1.671,-0.081
5,1789,1739,50,1.441,1.401,0.040
5,1657,2274,-617,1.335,1.832,-0.497
5,2152,1853,299,1.734,1.493,0.241
5,1871,1451,420,1.507,1.169,0.338
5,2094,2068,26,1.687,1.666,0.021
5,2243,2390,-147,1.807,1.925,-0.118
5,2419,1992,427,1.949,1.605,0.344
5,2331,2212,119,1.878,1.782,0.096
5,1671,2326,-655,1.346,1.874,-0.528
5,1880,2120,-240,1.515,1.708,-0.193
5,2041,1669,372,1.644,1.345,0.300
5,1937,1850,87,1.560,1.490,0.070
5,1813,1802,11,1.461,1.452,0.009
5,2383,2103,280,1.920,1.694,0.226
5,1912,2099,-187,1.540,1.691,-0.151
5,1948,2048,-100,1.569,1.650,-0.081
5,2426,1485,941,1.954,1.196,0.758
5,1649,2204,-555,1.328,1.776,-0.447
5,2375,1943,432,1.913,1.565,0.348
5,1868,1798,70,1.505,1.448,0.056
5,2433,1605,828,1.960,1.293,0.667
5,2130,1808,322,1.716,1.456,0.259
5,1917,2360,-443,1.544,1.901,-0.357
5,1543,1619,-76,1.243,1.304,-0.061
5,2026,1545,481,1.632,1.245,0.387
5,2123,1899,224,1.710,1.530,0.180
5,2374,1637,737,1.912,1.319,0.594
5,2104,1519,585,1.695,1.224,0.471
5,1924,1784,140,1.550,1.437,0.113
5,1999,1833,166,1.610,1.477,0.134
5,2259,1787,472,1.820,1.440,0.380
5,2416,2039,377,1.946,1.643,0.304
5,1660,1812,-152,1.337,1.460,-0.122
5,1873,2066,-193,1.509,1.664,-0.155
5,2096,1638,458,1.689,1.320,0.369
5,1706,1947,-241,1.374,1.568,-0.194
5,2130,1915,215,1.716,1.543,0.173
5,1771,2160,-389,1.427,1.740,-0.313
5,2234,1715,519,1.800,1.382,0.418
5,1773,2176,-403,1.428,1.753,-0.325
5,1891,1902,-11,1.523,1.532,-0.009
5,1815,1813,2,1.462,1.461,0.002
5,2083,2224,-141,1.678,1.792,-0.114
5,2198,1729,469,1.771,1.393,0.378
5,2005,1747,258,1.615,1.407,0.208
5,2067,2105,-38,1.665,1.696,-0.031
5,1549,1872,-323,1.248,1.508,-0.260
5,1928,2236,-308,1.553,1.801,-0.248
5,1725,1690,35,1.390,1.361,0.028
5,2224,2167,57,1.792,1.746,0.046
5,1627,1727,-100,1.311,1.391,-0.081
5,2421,1745,676,1.950,1.406,0.545
5,1754,2056,-302,1.413,1.656,-0.243
5,1513,2127,-614,1.219,1.713,-0.495
5,1850,1991,-141,1.490,1.604,-0.114
5,1757,2154,-397,1.415,1.735,-0.320
5,2332,2320,12,1.879,1.869,0.010
5,2034,2073,-39,1.639,1.670,-0.031
5,2196,1479,717,1.769,1.191,0.578
5,1550,2207,-657,1.249,1.778,-0.529
5,1494,2160,-666,1.204,1.740,-0.537
5,1923,1767,156,1.549,1.423,0.126
5,1894,1801,93,1.526,1.451,0.075
5,1551,1827,-276,1.249,1.472,-0.222
5,1938,2250,-312,1.561,1.813,-0.251
5,2220,2158,62,1.788,1.738,0.050
5,2031,1875,156,1.636,1.510,0.126
5,1588,1989,-401,1.279,1.602,-0.323
5,1907,2199,-292,1.536,1.771,-0.235
5,1948,2005,-57,1.569,1.615,-0.046
5,1980,2121,-141,1.595,1.709,-0.114
5,1624,2031,-407,1.308,1.636,-0.328
5,2375,1851,524,1.913,1.491,0.422
5,1660,1611,49,1.337,1.298,0.039
5,1516,1673,-157,1.221,1.348,-0.126
5,2206,1739,467,1.777,1.401,0.376
5,1658,1994,-336,1.336,1.606,-0.271
5,2120,1952,168,1.708,1.573,0.135
5,2036,2387,-351,1.640,1.923,-0.283
5,1848,1794,54,1.489,1.445,0.044
5,2166,2314,-148,1.745,1.864,-0.119
5,1511,1514,-3,1.217,1.220,-0.002
5,2405,2028,377,1.937,1.634,0.304
5,1895,2090,-195,1.527,1.684,-0.157
5,1655,2009,-354,1.333,1.618,-0.285
5,1824,2180,-356,1.469,1.756,-0.287
5,1591,1807,-216,1.282,1.456,-0.174
5,1984,2185,-201,1.598,1.760,-0.162
5,1754,1762,-8,1.413,1.419,-0.006
5,2151,2350,-199,1.733,1.893,-0.160
5,2125,2332,-207,1.712,1.879,-0.167
5,1903,1805,98,1.533,1.454,0.079
5,2148,1688,460,1.730,1.360,0.371
5,2176,1966,210,1.753,1.584,0.169
5,2105,1790,315,1.696,1.442,0.254
5,2158,1935,223,1.738,1.559,0.180
5,2008,2199,-191,1.618,1.771,-0.154
5,2068,1750,318,1.666,1.410,0.256
5,1970,1495,475,1.587,1.204,0.383
5,2232,1972,260,1.798,1.589,0.209
5,2059,2040,19,1.659,1.643,0.015
5,1808,2210,-402,1.456,1.780,-0.324
5,2017,2098,-81,1.625,1.690,-0.065
5,2066,1845,221,1.664,1.486,0.178
5,2162,2198,-36,1.742,1.771,-0.029
5,1655,2048,-393,1.333,1.650,-0.317
5,2014,1533,481,1.622,1.235,0.387
5,1945,2206,-261,1.567,1.777,-0.210
5,2278,2064,214,1.835,1.663,0.172
5,2394,1658,736,1.929,1.336,0.593
5,2188,1671,517,1.763,1.346,0.416
5,1887,2032,-145,1.520,1.637,-0.117
5,2159,2244,-85,1.739,1.808,-0.068
5,2153,2144,9,1.734,1.727,0.007
5,1795,1682,113,1.446,1.355,0.091
5,2054,1730,324,1.655,1.394,0.261
5,1901,1790,111,1.531,1.442,0.089
5,1923,1829,94,1.549,1.473,0.076
5,1791,2342,-551,1.443,1.887,-0.444
5,1855,2138,-283,1.494,1.722,-0.228
5,1537,2044,-507,1.238,1.647,-0.408
5,2268,1700,568,1.827,1.369,0.458
5,1705,1751,-46,1.374,1.411,-0.037
5,2228,1957,271,1.795,1.577,0.218
5,1619,1875,-256,1.304,1.510,-0.206
5,1881,1831,50,1.515,1.475,0.040
5,2158,1783,375,1.738,1.436,0.302
5,1847,2144,-297,1.488,1.727,-0.239
5,2008,1806,202,1.618,1.455,0.163
5,1662,1604,58,1.339,1.292,0.047
5,2027,2018,9,1.633,1.626,0.007
5,2037,2130,-93,1.641,1.716,-0.075
5,2104,1995,109,1.695,1.607,0.088
5,1865,1866,-1,1.502,1.503,-0.001
5,2136,1961,175,1.721,1.580,0.141
5,1624,1521,103,1.308,1.225,0.083
5,1931,1830,101,1.556,1.474,0.081
5,1685,1837,-152,1.357,1.480,-0.122
5,1901,1899,2,1.531,1.530,0.002
5,1854,1535,319,1.494,1.237,0.257
5,1897,1525,372,1.528,1.229,0.300
5,1577,2133,-556,1.270,1.718,-0.448
5,1794,1795,-1,1.445,1.446,-0.001
5,1651,2203,-552,1.330,1.775,-0.445
5,2337,1552,785,1.883,1.250,0.632
5,2074,1698,376,1.671,1.368,0.303
5,2132,2108,24,1.718,1.698,0.019
5,1780,1575,205,1.434,1.269,0.165
5,1942,1990,-48,1.564,1.603,-0.039
,,,0,0.000,0.000,0.000
5,2023,1850,173,1.630,1.490,0.139
5,2062,2202,-140,1.661,1.774,-0.113
5,1950,1998,-48,1.571,1.610,-0.039
5,1764,1958,-194,1.421,1.577,-0.156
5,1831,2229,-398,1.475,1.796,-0.321
5,1897,1933,-36,1.528,1.557,-0.029
5,2190,1453,737,1.764,1.171,0.594
5,1913,1865,48,1.541,1.502,0.039
5,1984,1771,213,1.598,1.427,0.172
5,1521,1718,-197,1.225,1.384,-0.159
5,1631,1927,-296,1.314,1.552,-0.238
5,1899,1987,-88,1.530,1.601,-0.071
5,1754,1479,275,1.413,1.191,0.222
5,2003,1736,267,1.614,1.398,0.215
5,2053,1890,163,1.654,1.523,0.131
5,1693,1903,-210,1.364,1.533,-0.169
5,2232,2012,220,1.798,1.621,0.177
5,2035,1456,579,1.639,1.173,0.466
5,1732,1925,-193,1.395,1.551,-0.155
5,1785,1769,16,1.438,1.425,0.013
5,1985,2069,-84,1.599,1.667,-0.068
5,1515,2019,-504,1.220,1.626,-0.406
5,1779,2122,-343,1.433,1.709,-0.276
5,1727,1775,-48,1.391,1.430,-0.039
5,1830,2227,-397,1.474,1.794,-0.320
5,2308,2130,178,1.859,1.716,0.143
5,2372,2153,219,1.911,1.734,0.176
5,2016,1761,255,1.624,1.419,0.205
5,2029,1668,361,1.635,1.344,0.291
5,2043,1777,266,1.646,1.432,0.214
5,2310,1888,422,1.861,1.521,0.340
5,1849,1737,112,1.490,1.399,0.090
5,2264,1795,469,1.824,1.446,0.378
5,2106,2096,10,1.697,1.689,0.008
5,2010,1743,267,1.619,1.404,0.215
5,1805,1593,212,1.454,1.283,0.171
5,2013,2096,-83,1.622,1.689,-0.067
5,1916,1750,166,1.544,1.410,0.134
5,1713,2114,-401,1.380,1.703,-0.323
5,2132,2164,-32,1.718,1.743,-0.026
5,1618,1772,-154,1.303,1.427,-0.124
5,1834,1836,-2,1.477,1.479,-0.002
5,1847,1930,-83,1.488,1.555,-0.067
5,2424,2246,178,1.953,1.809,0.143
5,2109,1584,525,1.699,1.276,0.423
5,1651,1860,-209,1.330,1.498,-0.168
5,2386,2114,272,1.922,1.703,0.219
5,2023,2116,-93,1.630,1.705,-0.075
5,2094,1922,172,1.687,1.548,0.139
5,1843,1473,370,1.485,1.187,0.298
5,1646,1601,45,1.326,1.290,0.036
5,1613,2076,-463,1.299,1.672,-0.373
5,2252,1974,278,1.814,1.590,0.224
5,1938,1736,202,1.561,1.398,0.163
5,2317,2089,228,1.867,1.683,0.184
5,2112,1531,581,1.701,1.233,0.468
5,1742,2096,-354,1.403,1.689,-0.285
5,2211,1985,226,1.781,1.599,0.182
5,2117,2048,69,1.705,1.650,0.056
5,2065,1952,113,1.664,1.573,0.091
5,2290,2121,169,1.845,1.709,0.136
5,1890,2184,-294,1.523,1.759,-0.237
5,1930,1577,353,1.555,1.270,0.284
5,1598,1988,-390,1.287,1.602,-0.314
5,1965,2114,-149,1.583,1.703,-0.120
5,1720,2111,-391,1.386,1.701,-0.315
5,2028,1716,312,1.634,1.382,0.251
5,1770,2115,-345,1.426,1.704,-0.278
5,1916,1675,241,1.544,1.349,0.194
5,1693,1745,-52,1.364,1.406,-0.042
5,2060,2092,-32,1.660,1.685,-0.026
5,2272,2111,161,1.830,1.701,0.130
5,2072,1757,315,1.669,1.415,0.254
5,1559,2011,-452,1.256,1.620,-0.364
5,2139,1873,266,1.723,1.509,0.214
5,2032,1665,367,1.637,1.341,0.296
5,2241,1610,631,1.805,1.297,0.508
5,1831,2024,-193,1.475,1.631,-0.155
5,1785,2133,-348,1.438,1.718,-0.280
5,1887,2134,-247,1.520,1.719,-0.199
5,1937,1850,87,1.560,1.490,0.070
5,2325,1704,621,1.873,1.373,0.500
5,2180,1808,372,1.756,1.456,0.300
5,1761,2074,-313,1.419,1.671,-0.252
5,2211,2048,163,1.781,1.650,0.131
5,1866,2005,-139,1.503,1.615,-0.112
5,2176,2145,31,1.753,1.728,0.025
5,2319,1984,335,1.868,1.598,0.270
5,1796,1579,217,1.447,1.272,0.175
5,2426,2056,370,1.954,1.656,0.298
5,2090,1583,507,1.684,1.275,0.408
5,2125,2068,57,1.712,1.666,0.046
5,1988,2027,-39,1.602,1.633,-0.031
5,1656,1880,-224,1.334,1.515,-0.180
5,1704,1815,-111,1.373,1.462,-0.089
5,2201,2202,-1,1.773,1.774,-0.001
5,2236,2190,46,1.801,1.764,0.037
5,2064,2066,-2,1.663,1.664,-0.002
5,1891,1987,-96,1.523,1.601,-0.077
5,1759,1963,-204,1.417,1.581,-0.164
5,2001,1916,85,1.612,1.544,0.068
5,1981,2033,-52,1.596,1.638,-0.042
5,1799,1953,-154,1.449,1.573,-0.124
5,1567,1626,-59,1.262,1.310,-0.048
5,1703,1666,37,1.372,1.342,0.030
5,1735,1702,33,1.398,1.371,0.027
5,2399,2346,53,1.933,1.890,0.043
5,2272,2219,53,1.830,1.788,0.043
5,1903,1990,-87,1.533,1.603,-0.070
5,2275,1927,348,1.833,1.552,0.280
5,1899,2152,-253,1.530,1.734,-0.204
5,2079,2134,-55,1.675,1.719,-0.044
5,2160,2210,-50,1.740,1.780,-0.040
5,1823,2079,-256,1.469,1.675,-0.206
5,1693,2102,-409,1.364,1.693,-0.329
5,1764,1820,-56,1.421,1.466,-0.045
5,2003,1791,212,1.614,1.443,0.171
5,1861,1811,50,1.499,1.459,0.040
5,2092,1580,512,1.685,1.273,0.412
5,1958,1909,49,1.577,1.538,0.039
5,1715,1975,-260,1.382,1.591,-0.209
5,1907,1863,44,1.536,1.501,0.035
5,2140,2190,-50,1.724,1.764,-0.040
5,1803,2007,-204,1.452,1.617,-0.164
5,1727,2301,-574,1.391,1.854,-0.462
5,1600,1760,-160,1.289,1.418,-0.129
5,2162,1541,621,1.742,1.241,0.500
5,1503,2108,-605,1.211,1.698,-0.487
5,1510,1557,-47,1.216,1.254,-0.038
5,1733,2348,-615,1.396,1.892,-0.495
5,2104,1902,202,1.695,1.532,0.163
5,1907,2363,-456,1.536,1.904,-0.367
5,1666,2121,-455,1.342,1.709,-0.367
5,2041,2185,-144,1.644,1.760,-0.116
5,1749,1646,103,1.409,1.326,0.083
5,2280,1499,781,1.837,1.208,0.629
5,1914,2286,-372,1.542,1.842,-0.300
5,2208,2101,107,1.779,1.693,0.086
5,2235,1821,414,1.800,1.467,0.334
5,2315,1898,417,1.865,1.529,0.336
5,2228,2219,9,1.795,1.788,0.007
5,1915,1973,-58,1.543,1.589,-0.047
5,1491,1538,-47,1.201,1.239,-0.038
5,1969,2224,-255,1.586,1.792,-0.205
5,1837,1841,-4,1.480,1.483,-0.003
5,1753,1755,-2,1.412,1.414,-0.002
5,1721,1970,-249,1.386,1.587,-0.201
5,2009,2150,-141,1.618,1.732,-0.114
5,1870,1925,-55,1.506,1.551,-0.044
5,2142,1932,210,1.726,1.556,0.169
5,1995,1791,204,1.607,1.443,0.164
5,1752,2260,-508,1.411,1.821,-0.409
5,2327,2153,174,1.875,1.734,0.140
5,1716,2269,-553,1.382,1.828,-0.445
5,1517,1670,-153,1.222,1.345,-0.123
5,1788,1893,-105,1.440,1.525,-0.085
5,1852,1656,196,1.492,1.334,0.158
5,2298,1887,411,1.851,1.520,0.331
5,1739,1930,-191,1.401,1.555,-0.154
5,2019,2058,-39,1.626,1.658,-0.031
5,1883,2238,-355,1.517,1.803,-0.286
5,2214,1855,359,1.784,1.494,0.289
5,2008,2045,-37,1.618,1.647,-0.030
5,2009,1691,318,1.618,1.362,0.256
5,2228,2058,170,1.795,1.658,0.137
5,2083,1723,360,1.678,1.388,0.290
5,2261,2361,-100,1.821,1.902,-0.081
5,2436,2211,225,1.962,1.781,0.181
5,2033,1667,366,1.638,1.343,0.295
5,1790,2036,-246,1.442,1.640,-0.198
5,2422,1751,671,1.951,1.411,0.541
5,1870,2373,-503,1.506,1.912,-0.405
5,1777,1869,-92,1.432,1.506,-0.074
5,1626,2133,-507,1.310,1.718,-0.408
5,2264,2042,222,1.824,1.645,0.179
5,2124,2059,65,1.711,1.659,0.052
5,2350,1959,391,1.893,1.578,0.315
5,1565,1662,-97,1.261,1.339,-0.078
5,1986,1924,62,1.600,1.550,0.050
5,1692,1743,-51,1.363,1.404,-0.041
5,2171,1809,362,1.749,1.457,0.292
5,1772,1968,-196,1.427,1.585,-0.158
5,1831,2128,-297,1.475,1.714,-0.239
5,1642,1904,-262,1.323,1.534,-0.211
5,1503,1549,-46,1.211,1.248,-0.037
5,1721,1471,250,1.386,1.185,0.201
5,2160,1907,253,1.740,1.536,0.204
5,1917,2074,-157,1.544,1.671,-0.126
5,1979,2327,-348,1.594,1.875,-0.280
5,2196,2179,17,1.769,1.755,0.014
5,1936,1688,248,1.560,1.360,0.200
5,1806,2163,-357,1.455,1.742,-0.288
5,2405,1836,569,1.937,1.479,0.458
5,1899,1939,-40,1.530,1.562,-0.032
5,2232,1874,358,1.798,1.510,0.288
5,1716,2120,-404,1.382,1.708,-0.325
5,1633,2086,-453,1.316,1.680,-0.365
5,2116,1854,262,1.705,1.494,0.211
5,1914,2209,-295,1.542,1.780,-0.238
5,1878,2128,-250,1.513,1.714,-0.201
5,1838,1740,98,1.481,1.402,0.079
5,2015,1605,410,1.623,1.293,0.330
5,1572,1777,-205,1.266,1.432,-0.165
5,2213,1699,514,1.783,1.369,0.414
5,2014,1917,97,1.622,1.544,0.078
5,2134,2377,-243,1.719,1.915,-0.196
5,1929,1732,197,1.554,1.395,0.159
5,2055,2340,-285,1.655,1.885,-0.230
5,1936,1742,194,1.560,1.403,0.156
5,1548,2203,-655,1.247,1.775,-0.528
5,2124,2374,-250,1.711,1.912,-0.201
5,1770,1499,271,1.426,1.208,0.218
5,1817,1919,-102,1.464,1.546,-0.082
5,2236,1919,317,1.801,1.546,0.255
5,2085,2379,-294,1.680,1.916,-0.237
5,1527,2351,-824,1.230,1.894,-0.664
5,1583,2300,-717,1.275,1.853,-0.578
5,1644,1907,-263,1.324,1.536,-0.212
5,2015,2048,-33,1.623,1.650,-0.027
5,1610,2268,-658,1.297,1.827,-0.530
5,1627,2080,-453,1.311,1.676,-0.365
5,1994,1679,315,1.606,1.353,0.254
5,1749,1807,-58,1.409,1.456,-0.047
5,1822,1919,-97,1.468,1.546,-0.078
5,1572,1784,-212,1.266,1.437,-0.171
5,1749,2205,-456,1.409,1.776,-0.367
5,1812,2159,-347,1.460,1.739,-0.280
5,1716,2017,-301,1.382,1.625,-0.242
5,1622,1618,4,1.307,1.303,0.003
5,2052,1633,419,1.653,1.316,0.338
5,2168,2152,16,1.747,1.734,0.013
5,1917,1763,154,1.544,1.420,0.124
5,1978,1670,308,1.593,1.345,0.248
5,2103,1694,409,1.694,1.365,0.329
5,2116,2112,4,1.705,1.701,0.003
5,1677,2028,-351,1.351,1.634,-0.283
5,2153,1585,568,1.734,1.277,0.458
5,2115,2214,-99,1.704,1.784,-0.080
5,2078,1917,161,1.674,1.544,0.130
5,1971,1907,64,1.588,1.536,0.052
5,1656,1919,-263,1.334,1.546,-0.212
5,1780,1625,155,1.434,1.309,0.125
5,2314,2049,265,1.864,1.651,0.213
5,1499,2216,-717,1.208,1.785,-0.578
5,1778,1771,7,1.432,1.427,0.006
5,1922,2024,-102,1.548,1.631,-0.082
5,1736,2092,-356,1.398,1.685,-0.287
5,1646,2048,-402,1.326,1.650,-0.324
5,1919,1708,211,1.546,1.376,0.170
5,1565,1671,-106,1.261,1.346,-0.085
5,1643,2252,-609,1.324,1.814,-0.491
5,1718,2384,-666,1.384,1.921,-0.537
5,1924,1986,-62,1.550,1.600,-0.050
5,1541,1747,-206,1.241,1.407,-0.166
5,1958,2151,-193,1.577,1.733,-0.155
5,2435,1923,512,1.962,1.549,0.412
5,2088,1782,306,1.682,1.436,0.247
5,1486,1585,-99,1.197,1.277,-0.080
5,1494,1552,-58,1.204,1.250,-0.047
5,2190,1725,465,1.764,1.390,0.375
5,1737,1791,-54,1.399,1.443,-0.044
5,2321,2114,207,1.870,1.703,0.167
5,2077,1726,351,1.673,1.390,0.283
5,1736,1740,-4,1.398,1.402,-0.003
5,1501,2216,-715,1.209,1.785,-0.576
5,1829,2388,-559,1.473,1.924,-0.450
5,1542,1866,-324,1.242,1.503,-0.261
5,1723,1928,-205,1.388,1.553,-0.165
5,2151,2147,4,1.733,1.730,0.003
5,2336,1820,516,1.882,1.466,0.416
5,2252,1730,522,1.814,1.394,0.421
5,2211,2160,51,1.781,1.740,0.041
5,2132,1915,217,1.718,1.543,0.175
5,2228,2161,67,1.795,1.741,0.054
5,1668,2179,-511,1.344,1.755,-0.412
5,1789,2192,-403,1.441,1.766,-0.325
5,2164,2207,-43,1.743,1.778,-0.035
5,2173,1711,462,1.751,1.378,0.372
5,1833,2233,-400,1.477,1.799,-0.322
5,2211,2088,123,1.781,1.682,0.099
5,2319,2369,-50,1.868,1.908,-0.040
5,1873,2124,-251,1.509,1.711,-0.202
5,1889,1781,108,1.522,1.435,0.087
5,1995,2247,-252,1.607,1.810,-0.203
5,2279,1652,627,1.836,1.331,0.505
5,2134,1873,261,1.719,1.509,0.210
5,2192,1737,455,1.766,1.399,0.367
5,2158,1480,678,1.738,1.192,0.546
5,1903,1636,267,1.533,1.318,0.215
5,2016,2307,-291,1.624,1.858,-0.234
5,1764,1871,-107,1.421,1.507,-0.086
5,1989,2075,-86,1.602,1.672,-0.069
5,1530,2091,-561,1.233,1.684,-0.452
5,2318,1750,568,1.867,1.410,0.458
5,2073,2320,-247,1.670,1.869,-0.199
5,1982,1971,11,1.597,1.588,0.009
5,2053,1795,258,1.654,1.446,0.208
5,1541,1693,-152,1.241,1.364,-0.122
5,1714,2016,-302,1.381,1.624,-0.243
5,1775,2166,-391,1.430,1.745,-0.315
5,1522,1931,-409,1.226,1.556,-0.329
5,1491,2157,-666,1.201,1.738,-0.537
5,1919,2067,-148,1.546,1.665,-0.119
5,1989,2030,-41,1.602,1.635,-0.033
5,1851,1704,147,1.491,1.373,0.118
5,1767,1881,-114,1.423,1.515,-0.092
5,2050,1899,151,1.651,1.530,0.122
5,2432,1549,883,1.959,1.248,0.711
5,1842,1793,49,1.484,1.444,0.039
5,2130,1671,459,1.716,1.346,0.370
5,1799,2095,-296,1.449,1.688,-0.238
5,2272,1764,508,1.830,1.421,0.409
5,1899,1694,205,1.530,1.365,0.165
5,2076,1818,258,1.672,1.465,0.208
5,1629,1795,-166,1.312,1.446,-0.134
5,2064,2159,-95,1.663,1.739,-0.077
5,1667,1974,-307,1.343,1.590,-0.247
5,1999,1940,59,1.610,1.563,0.048
5,2280,2224,56,1.837,1.792,0.045
5,1729,2031,-302,1.393,1.636,-0.243
5,1695,1490,205,1.365,1.200,0.165
5,1818,1714,104,1.465,1.381,0.084
5,1833,1831,2,1.477,1.475,0.002
5,2114,1807,307,1.703,1.456,0.247
5,2079,1887,192,1.675,1.520,0.155
5,1756,1539,217,1.415,1.240,0.175
5,2158,1936,222,1.738,1.560,0.179
5,1814,2217,-403,1.461,1.786,-0.325
5,1914,1511,403,1.542,1.217,0.325
5,1789,2140,-351,1.441,1.724,-0.283
5,1915,2221,-306,1.543,1.789,-0.247
5,1579,1839,-260,1.272,1.481,-0.209
5,1970,2228,-258,1.587,1.795,-0.208
5,2160,1908,252,1.740,1.537,0.203
5,1822,1877,-55,1.468,1.512,-0.044
5,2419,2356,63,1.949,1.898,0.051
5,2118,1957,161,1.706,1.577,0.130
5,2093,1530,563,1.686,1.233,0.454
5,2282,2120,162,1.838,1.708,0.131
5,1995,2150,-155,1.607,1.732,-0.125
5,2078,2020,58,1.674,1.627,0.047
5,2264,1583,681,1.824,1.275,0.549
5,2432,1856,576,1.959,1.495,0.464
5,1921,1502,419,1.548,1.210,0.338
5,2211,1492,719,1.781,1.202,0.579
5,2242,1734,508,1.806,1.397,0.409
5,1710,1705,5,1.378,1.374,0.004
5,1562,1920,-358,1.258,1.547,-0.288
5,1794,1843,-49,1.445,1.485,-0.039
5,1922,2228,-306,1.548,1.795,-0.247
5,1792,1940,-148,1.444,1.563,-0.119
5,1970,2120,-150,1.587,1.708,-0.121
5,1684,2040,-356,1.357,1.643,-0.287
5,2016,1866,150,1.624,1.503,0.121
5,1882,1937,-55,1.516,1.560,-0.044
5,2144,1634,510,1.727,1.316,0.411
5,2112,2048,64,1.701,1.650,0.052
5,1813,1807,6,1.461,1.456,0.005
5,1723,2176,-453,1.388,1.753,-0.365
5,1886,1780,106,1.519,1.434,0.085
5,1938,1932,6,1.561,1.556,0.005
5,1757,2107,-350,1.415,1.697,-0.282
5,1674,1772,-98,1.349,1.427,-0.079
5,1841,2192,-351,1.483,1.766,-0.283
5,1916,2055,-139,1.544,1.655,-0.112
5,2194,1729,465,1.767,1.393,0.375
5,2209,1849,360,1.780,1.490,0.290
5,1974,2221,-247,1.590,1.789,-0.199
5,2144,1923,221,1.727,1.549,0.178
5,1697,1709,-12,1.367,1.377,-0.010
5,2094,1847,247,1.687,1.488,0.199
5,2437,2113,324,1.963,1.702,0.261
5,1831,1935,-104,1.475,1.559,-0.084
5,2058,2003,55,1.658,1.614,0.044
5,1879,1832,47,1.514,1.476,0.038
5,2003,2056,-53,1.614,1.656,-0.043
5,1982,2085,-103,1.597,1.680,-0.083
5,2266,2212,54,1.825,1.782,0.044
5,1920,2387,-467,1.547,1.923,-0.376
5,2118,1556,562,1.706,1.253,0.453
5,2254,2034,220,1.816,1.639,0.177
5,1745,2153,-408,1.406,1.734,-0.329
5,2187,1779,408,1.762,1.433,0.329
5,1647,2312,-665,1.327,1.863,-0.536
5,2098,1534,564,1.690,1.236,0.454
5,1921,1462,459,1.548,1.178,0.370
5,1793,1935,-142,1.444,1.559,-0.114
5,1813,2218,-405,1.461,1.787,-0.326
5,1734,1851,-117,1.397,1.491,-0.094
5,2023,1661,362,1.630,1.338,0.292
5,1830,2080,-250,1.474,1.676,-0.201
5,2270,1710,560,1.829,1.378,0.451
5,2308,1932,376,1.859,1.556,0.303
5,2282,2014,268,1.838,1.622,0.216
5,1843,1578,265,1.485,1.271,0.213
5,2014,1865,149,1.622,1.502,0.120
5,2184,2014,170,1.759,1.622,0.137
5,1788,2034,-246,1.440,1.639,-0.198
5,1749,2051,-302,1.409,1.652,-0.243
5,2331,2060,271,1.878,1.660,0.218
5,2299,2294,5,1.852,1.848,0.004
5,1694,2149,-455,1.365,1.731,-0.367
5,1599,1761,-162,1.288,1.419,-0.131
5,1978,2177,-199,1.593,1.754,-0.160
5,1585,2001,-416,1.277,1.612,-0.335
5,1874,2227,-353,1.510,1.794,-0.284
5,1739,2086,-347,1.401,1.680,-0.280
5,1553,1655,-102,1.251,1.333,-0.082
5,2083,1773,310,1.678,1.428,0.250
5,2049,2033,16,1.651,1.638,0.013
5,2429,1495,934,1.957,1.204,0.752
5,1671,1785,-114,1.346,1.438,-0.092
5,2162,1910,252,1.742,1.539,0.203
5,1916,1913,3,1.544,1.541,0.002
5,2181,2167,14,1.757,1.746,0.011
5,1887,1527,360,1.520,1.230,0.290
5,2117,1494,623,1.705,1.204,0.502
5,1972,2268,-296,1.589,1.827,-0.238
5,1573,1726,-153,1.267,1.390,-0.123
5,1939,1847,92,1.562,1.488,0.074
5,2132,2337,-205,1.718,1.883,-0.165
5,1485,1990,-505,1.196,1.603,-0.407
5,2333,1555,778,1.879,1.253,0.627
5,2255,1990,265,1.817,1.603,0.213
5,1807,2370,-563,1.456,1.909,-0.454
5,1779,1974,-195,1.433,1.590,-0.157
5,2052,1806,246,1.653,1.455,0.198
5,2385,1669,716,1.921,1.345,0.577
5,1594,2168,-574,1.284,1.747,-0.462
5,1640,1907,-267,1.321,1.536,-0.215
5,1969,2176,-207,1.586,1.753,-0.167
5,1999,1807,192,1.610,1.456,0.155
5,1985,2036,-51,1.599,1.640,-0.041
5,1561,2014,-453,1.258,1.622,-0.365
5,1929,1636,293,1.554,1.318,0.236
5,1859,2368,-509,1.498,1.908,-0.410
5,1873,1933,-60,1.509,1.557,-0.048
5,1495,1914,-419,1.204,1.542,-0.338
5,1567,2181,-614,1.262,1.757,-0.495
5,2298,2089,209,1.851,1.683,0.168
5,2376,2370,6,1.914,1.909,0.005
5,2123,1915,208,1.710,1.543,0.168
5,1772,1614,158,1.427,1.300,0.127
5,2204,1940,264,1.776,1.563,0.213
5,1507,2124,-617,1.214,1.711,-0.497
5,1903,2212,-309,1.533,1.782,-0.249
5,2025,1723,302,1.631,1.388,0.243
5,1893,2348,-455,1.525,1.892,-0.367
5,1965,2220,-255,1.583,1.788,-0.205
5,2362,2148,214,1.903,1.730,0.172
5,1771,1841,-70,1.427,1.483,-0.056
5,1651,1763,-112,1.330,1.420,-0.090
5,2039,1987,52,1.643,1.601,0.042
5,1869,2013,-144,1.506,1.622,-0.116
5,1846,2093,-247,1.487,1.686,-0.199
5,1815,2072,-257,1.462,1.669,-0.207
5,1730,2345,-615,1.394,1.889,-0.495
5,1496,2166,-670,1.205,1.745,-0.540
5,1627,1738,-111,1.311,1.400,-0.089
5,1764,2025,-261,1.421,1.631,-0.210
5,2010,2157,-147,1.619,1.738,-0.118
5,2345,1731,614,1.889,1.394,0.495
5,1703,2367,-664,1.372,1.907,-0.535
5,1579,1742,-163,1.272,1.403,-0.131
5,1960,1866,94,1.579,1.503,0.076
5,1583,1941,-358,1.275,1.564,-0.288
5,2016,2115,-99,1.624,1.704,-0.080
5,2096,1744,352,1.689,1.405,0.284
5,2173,1713,460,1.751,1.380,0.371
5,2254,1643,611,1.816,1.324,0.492
5,1665,2236,-571,1.341,1.801,-0.460
5,2208,1990,218,1.779,1.603,0.176
5,1768,1567,201,1.424,1.262,0.162
5,1587,1914,-327,1.278,1.542,-0.263
5,1889,1935,-46,1.522,1.559,-0.037
5,2274,1648,626,1.832,1.328,0.504
5,2190,1887,303,1.764,1.520,0.244
5,1861,1702,159,1.499,1.371,0.128
5,1982,1981,1,1.597,1.596,0.001
5,2210,1754,456,1.780,1.413,0.367
5,2134,1978,156,1.719,1.593,0.126
5,2176,1662,514,1.753,1.339,0.414
5,2052,1692,360,1.653,1.363,0.290
5,1817,1461,356,1.464,1.177,0.287
5,1800,1696,104,1.450,1.366,0.084
5,2184,1713,471,1.759,1.380,0.379
5,2406,1729,677,1.938,1.393,0.545
5,1902,1852,50,1.532,1.492,0.040
5,2281,1823,458,1.838,1.469,0.369
5,1905,2156,-251,1.535,1.737,-0.202
5,1965,2060,-95,1.583,1.660,-0.077
5,1982,1781,201,1.597,1.435,0.162
5,1596,1944,-348,1.286,1.566,-0.280
5,1721,1884,-163,1.386,1.518,-0.131
5,1939,1994,-55,1.562,1.606,-0.044
5,1615,1620,-5,1.301,1.305,-0.004
5,2106,2048,58,1.697,1.650,0.047
5,1823,2073,-250,1.469,1.670,-0.201
5,1899,2106,-207,1.530,1.697,-0.167
5,2241,1783,458,1.805,1.436,0.369
5,1903,2259,-356,1.533,1.820,-0.287
5,2392,2230,162,1.927,1.796,0.131
5,2410,1731,679,1.941,1.394,0.547
5,1853,2157,-304,1.493,1.738,-0.245
5,2243,1727,516,1.807,1.391,0.416
5,2045,1478,567,1.647,1.191,0.457
5,2073,1663,410,1.670,1.340,0.330
5,2050,2143,-93,1.651,1.726,-0.075
5,1767,2005,-238,1.423,1.615,-0.192
5,1883,1575,308,1.517,1.269,0.248
5,1796,1749,47,1.447,1.409,0.038
5,1661,2170,-509,1.338,1.748,-0.410
5,2100,2252,-152,1.692,1.814,-0.122
5,1704,2104,-400,1.373,1.695,-0.322
5,2074,1498,576,1.671,1.207,0.464
5,2088,1673,415,1.682,1.348,0.334
5,1737,1976,-239,1.399,1.592,-0.193
5,1855,1946,-91,1.494,1.568,-0.073
5,1976,1923,53,1.592,1.549,0.043
5,2141,2286,-145,1.725,1.842,-0.117
5,2264,2154,110,1.824,1.735,0.089
5,1563,1511,52,1.259,1.217,0.042
5,1900,1935,-35,1.531,1.559,-0.028
5,1595,2058,-463,1.285,1.658,-0.373
5,1918,1878,40,1.545,1.513,0.032
5,1784,1980,-196,1.437,1.595,-0.158
5,1491,1918,-427,1.201,1.545,-0.344
5,1979,1964,15,1.594,1.582,0.012
5,1631,1802,-171,1.314,1.452,-0.138
5,1717,1780,-63,1.383,1.434,-0.051
5,2003,2359,-356,1.614,1.900,-0.287
5,2231,2058,173,1.797,1.658,0.139
5,1882,2132,-250,1.516,1.718,-0.201
5,1850,1915,-65,1.490,1.543,-0.052
5,2070,1503,567,1.668,1.211,0.457
5,1881,2184,-303,1.515,1.759,-0.244
5,2059,1491,568,1.659,1.201,0.458
5,2237,1718,519,1.802,1.384,0.418
5,2144,2025,119,1.727,1.631,0.096
5,1839,2038,-199,1.481,1.642,-0.160
5,1870,1875,-5,1.506,1.510,-0.004
5,1525,2096,-571,1.229,1.689,-0.460
5,2278,1709,569,1.835,1.377,0.458
5,2248,1981,267,1.811,1.596,0.215
5,1966,2121,-155,1.584,1.709,-0.125
5,2420,1814,606,1.950,1.461,0.488
5,1528,2247,-719,1.231,1.810,-0.579
5,2179,1967,212,1.755,1.585,0.171
5,2048,1586,462,1.650,1.278,0.372
5,2076,1865,211,1.672,1.502,0.170
5,1767,1917,-150,1.423,1.544,-0.121
5,1521,1827,-306,1.225,1.472,-0.247
5,2104,1599,505,1.695,1.288,0.407
5,1717,1821,-104,1.383,1.467,-0.084
5,2260,2002,258,1.821,1.613,0.208
5,1826,2233,-407,1.471,1.799,-0.328
5,2425,2158,267,1.954,1.738,0.215
5,2027,2070,-43,1.633,1.668,-0.035
5,1589,1695,-106,1.280,1.365,-0.085
5,1710,1871,-161,1.378,1.507,-0.130
5,1797,2104,-307,1.448,1.695,-0.247
5,1917,1767,150,1.544,1.423,0.121
5,1640,1745,-105,1.321,1.406,-0.085
5,1763,2332,-569,1.420,1.879,-0.458
5,1532,1634,-102,1.234,1.316,-0.082
5,2013,1799,214,1.622,1.449,0.172
5,2136,1922,214,1.721,1.548,0.172
5,2158,1855,303,1.738,1.494,0.244
5,2128,1868,260,1.714,1.505,0.209
5,1930,1991,-61,1.555,1.604,-0.049
5,1499,1817,-318,1.208,1.464,-0.256
5,2039,2088,-49,1.643,1.682,-0.039
5,1919,2014,-95,1.546,1.622,-0.077
5,2094,2030,64,1.687,1.635,0.052
5,2049,2023,26,1.651,1.630,0.021
5,1493,2304,-811,1.203,1.856,-0.653
5,2280,2265,15,1.837,1.825,0.012
5,2026,1775,251,1.632,1.430,0.202
5,2097,1791,306,1.689,1.443,0.247
5,2167,1801,366,1.746,1.451,0.295
5,1718,2230,-512,1.384,1.796,-0.412
5,1893,1691,202,1.525,1.362,0.163
5,1660,1709,-49,1.337,1.377,-0.039
5,1722,1774,-52,1.387,1.429,-0.042
5,1834,1577,257,1.477,1.270,0.207
5,2260,1846,414,1.821,1.487,0.334
5,1709,2057,-348,1.377,1.657,-0.280
5,1712,2059,-347,1.379,1.659,-0.280
5,2078,2330,-252,1.674,1.877,-0.203
5,1626,1988,-362,1.310,1.602,-0.292
5,1549,2312,-763,1.248,1.863,-0.615
5,1822,1618,204,1.468,1.303,0.164
5,1633,1471,162,1.316,1.185,0.131
5,1938,1856,82,1.561,1.495,0.066
5,2277,1606,671,1.834,1.294,0.541
5,2040,1984,56,1.643,1.598,0.045
5,1918,1553,365,1.545,1.251,0.294
5,1925,1980,-55,1.551,1.595,-0.044
5,1752,1918,-166,1.411,1.545,-0.134
5,1985,1921,64,1.599,1.548,0.052
5,2376,1768,608,1.914,1.424,0.490
5,2276,1843,433,1.834,1.485,0.349
5,1814,1547,267,1.461,1.246,0.215
5,2236,2221,15,1.801,1.789,0.012
5,2248,1778,470,1.811,1.432,0.379
5,1903,1687,216,1.533,1.359,0.174
5,1807,2110,-303,1.456,1.700,-0.244
5,2246,2036,210,1.809,1.640,0.169
5,1636,2200,-564,1.318,1.772,-0.454
5,2380,2216,164,1.917,1.785,0.132
5,1725,1787,-62,1.390,1.440,-0.050
5,1905,1911,-6,1.535,1.539,-0.005
5,2189,1988,201,1.763,1.602,0.162
5,2174,2112,62,1.751,1.701,0.050
5,2098,1782,316,1.690,1.436,0.255
5,1743,1803,-60,1.404,1.452,-0.048
5,1775,2128,-353,1.430,1.714,-0.284
5,1580,2081,-501,1.273,1.676,-0.404
5,1752,1956,-204,1.411,1.576,-0.164
5,2238,1721,517,1.803,1.386,0.416
5,1742,1785,-43,1.403,1.438,-0.035
5,1854,1956,-102,1.494,1.576,-0.082
5,1768,1816,-48,1.424,1.463,-0.039
5,2296,1629,667,1.850,1.312,0.537
5,1702,2005,-303,1.371,1.615,-0.244
5,2244,2227,17,1.808,1.794,0.014
5,2053,1545,508,1.654,1.245,0.409
5,1878,1466,412,1.513,1.181,0.332
5,1743,1493,250,1.404,1.203,0.201
5,1977,1672,305,1.593,1.347,0.246
5,1791,1944,-153,1.443,1.566,-0.123
5,1723,2385,-662,1.388,1.921,-0.533
,,,0,0.000,0.000,0.000
5,2015,1760,255,1.623,1.418,0.205
5,1621,2128,-507,1.306,1.714,-0.408
5,1539,1994,-455,1.240,1.606,-0.367
5,1865,2223,-358,1.502,1.791,-0.288
5,1683,1940,-257,1.356,1.563,-0.207
5,2116,2160,-44,1.705,1.740,-0.035
5,2036,2129,-93,1.640,1.715,-0.075
5,2373,1594,779,1.912,1.284,0.628
5,1723,1977,-254,1.388,1.593,-0.205
5,1847,1903,-56,1.488,1.533,-0.045
5,2130,1828,302,1.716,1.473,0.243
5,1637,1948,-311,1.319,1.569,-0.251
5,1829,1824,5,1.473,1.469,0.004
5,2104,1791,313,1.695,1.443,0.252
5,1649,1857,-208,1.328,1.496,-0.168
5,1697,1789,-92,1.367,1.441,-0.074
5,1603,1827,-224,1.291,1.472,-0.180
5,1937,1850,87,1.560,1.490,0.070
5,1813,2001,-188,1.461,1.612,-0.151
5,2139,1929,210,1.723,1.554,0.169
5,1538,2364,-826,1.239,1.904,-0.665
5,1875,2183,-308,1.510,1.759,-0.248
5,2062,1480,582,1.661,1.192,0.469
5,2182,2172,10,1.758,1.750,0.008
5,1693,2372,-679,1.364,1.911,-0.547
5,1678,2089,-411,1.352,1.683,-0.331
5,2116,2109,7,1.705,1.699,0.006
5,2040,1843,197,1.643,1.485,0.159
5,2124,2222,-98,1.711,1.790,-0.079
5,1887,1981,-94,1.520,1.596,-0.076
5,2163,1492,671,1.742,1.202,0.541
5,2242,1785,457,1.806,1.438,0.368
5,2076,2178,-102,1.672,1.755,-0.082
5,1694,1547,147,1.365,1.246,0.118
5,2245,1978,267,1.809,1.593,0.215
5,1853,2211,-358,1.493,1.781,-0.288
5,2238,1974,264,1.803,1.590,0.213
5,2166,1488,678,1.745,1.199,0.546
5,2129,1564,565,1.715,1.260,0.455
5,1692,1998,-306,1.363,1.610,-0.247
5,1723,1774,-51,1.388,1.429,-0.041
5,1741,2048,-307,1.403,1.650,-0.247
5,1912,1720,192,1.540,1.386,0.155
5,2420,1992,428,1.950,1.605,0.345
5,1665,2173,-508,1.341,1.751,-0.409
5,1637,1595,42,1.319,1.285,0.034
5,1565,2087,-522,1.261,1.681,-0.421
5,1552,2014,-462,1.250,1.622,-0.372
5,1999,2248,-249,1.610,1.811,-0.201
5,2232,1517,715,1.798,1.222,0.576
5,2367,1703,664,1.907,1.372,0.535
5,2141,2092,49,1.725,1.685,0.039
5,2186,2226,-40,1.761,1.793,-0.032
5,2052,2106,-54,1.653,1.697,-0.044
5,2147,1887,260,1.730,1.520,0.209
5,2374,1815,559,1.912,1.462,0.450
5,2034,2034,0,1.639,1.639,0.000
5,1967,1722,245,1.585,1.387,0.197
5,2104,1748,356,1.695,1.408,0.287
5,1830,2193,-363,1.474,1.767,-0.292
5,1858,1819,39,1.497,1.465,0.031
5,2252,1684,568,1.814,1.357,0.458
5,2178,1569,609,1.755,1.264,0.491
5,1653,2218,-565,1.332,1.787,-0.455
5,2043,2348,-305,1.646,1.892,-0.246
5,1755,2110,-355,1.414,1.700,-0.286
5,2416,1999,417,1.946,1.610,0.336
5,1836,1534,302,1.479,1.236,0.243
5,1726,1930,-204,1.390,1.555,-0.164
5,1962,2111,-149,1.581,1.701,-0.120
5,2144,1887,257,1.727,1.520,0.207
5,2173,1558,615,1.751,1.255,0.495
5,1929,2035,-106,1.554,1.639,-0.085
5,1961,1769,192,1.580,1.425,0.155
5,1695,2214,-519,1.365,1.784,-0.418
5,1881,1731,150,1.515,1.394,0.121
5,2120,2124,-4,1.708,1.711,-0.003
5,1704,2021,-317,1.373,1.628,-0.255
5,1804,1869,-65,1.453,1.506,-0.052
5,1484,1650,-166,1.195,1.329,-0.134
5,1577,1905,-328,1.270,1.535,-0.264
5,1914,2083,-169,1.542,1.678,-0.136
5,1776,2294,-518,1.431,1.848,-0.417
5,2240,2190,50,1.805,1.764,0.040
5,1661,1927,-266,1.338,1.552,-0.214
5,1692,2009,-317,1.363,1.618,-0.255
5,2112,1453,659,1.701,1.171,0.531
5,1897,2196,-299,1.528,1.769,-0.241
5,2280,1923,357,1.837,1.549,0.288
5,1795,2212,-417,1.446,1.782,-0.336
5,1729,1938,-209,1.393,1.561,-0.168
5,2074,1665,409,1.671,1.341,0.329
5,2304,1905,399,1.856,1.535,0.321
5,2179,1768,411,1.755,1.424,0.331
5,2050,2204,-154,1.651,1.776,-0.124
5,1923,2182,-259,1.549,1.758,-0.209
5,2275,2163,112,1.833,1.742,0.090
5,1794,2102,-308,1.445,1.693,-0.248
5,2244,2041,203,1.808,1.644,0.164
5,1870,1834,36,1.506,1.477,0.029
5,2229,1923,306,1.796,1.549,0.247
5,1911,2388,-477,1.539,1.924,-0.384
5,2015,2012,3,1.623,1.621,0.002
5,2108,2108,0,1.698,1.698,0.000
5,2419,1915,504,1.949,1.543,0.406
5,2354,2096,258,1.896,1.689,0.208
5,2144,2045,99,1.727,1.647,0.080
5,2389,2074,315,1.925,1.671,0.254
5,1753,2217,-464,1.412,1.786,-0.374
5,2046,1917,129,1.648,1.544,0.104
5,2299,2244,55,1.852,1.808,0.044
5,1870,1975,-105,1.506,1.591,-0.085
5,1489,2062,-573,1.200,1.661,-0.462
5,2408,1992,416,1.940,1.605,0.335
5,1975,1724,251,1.591,1.389,0.202
5,1797,1813,-16,1.448,1.461,-0.013
5,1839,1854,-15,1.481,1.494,-0.012
5,2240,2231,9,1.805,1.797,0.007
5,1702,2257,-555,1.371,1.818,-0.447
5,2079,2200,-121,1.675,1.772,-0.097
5,1828,1627,201,1.473,1.311,0.162
5,1807,2060,-253,1.456,1.660,-0.204
5,1781,2034,-253,1.435,1.639,-0.204
5,2383,1460,923,1.920,1.176,0.744
5,2055,2163,-108,1.655,1.742,-0.087
5,1673,2087,-414,1.348,1.681,-0.334
5,1713,1725,-12,1.380,1.390,-0.010
5,1904,2055,-151,1.534,1.655,-0.122
5,1995,1588,407,1.607,1.279,0.328
5,1655,1728,-73,1.333,1.392,-0.059
5,1971,1663,308,1.588,1.340,0.248
5,2208,1915,293,1.779,1.543,0.236
5,1834,1994,-160,1.477,1.606,-0.129
5,1671,2089,-418,1.346,1.683,-0.337
5,1973,1886,87,1.589,1.519,0.070
5,2065,1827,238,1.664,1.472,0.192
5,1704,1713,-9,1.373,1.380,-0.007
5,2361,1750,611,1.902,1.410,0.492
5,1879,1623,256,1.514,1.307,0.206
5,1752,1772,-20,1.411,1.427,-0.016
5,1646,2058,-412,1.326,1.658,-0.332
5,1683,2205,-522,1.356,1.776,-0.421
5,1829,1740,89,1.473,1.402,0.072
5,2180,1776,404,1.756,1.431,0.325
5,2114,1923,191,1.703,1.549,0.154
5,2158,2164,-6,1.738,1.743,-0.005
5,2048,2101,-53,1.650,1.693,-0.043
5,2394,1900,494,1.929,1.531,0.398
5,1974,1583,391,1.590,1.275,0.315
5,1568,1848,-280,1.263,1.489,-0.226
5,2308,2320,-12,1.859,1.869,-0.010
5,2364,1450,914,1.904,1.168,0.736
5,2017,1582,435,1.625,1.274,0.350
5,2234,2197,37,1.800,1.770,0.030
5,2146,2366,-220,1.729,1.906,-0.177
5,1788,1768,20,1.440,1.424,0.016
5,1541,1711,-170,1.241,1.378,-0.137
5,1532,1712,-180,1.234,1.379,-0.145
5,1899,1505,394,1.530,1.212,0.317
5,2112,2226,-114,1.701,1.793,-0.092
5,2265,1957,308,1.825,1.577,0.248
5,1997,1862,135,1.609,1.500,0.109
5,1734,1706,28,1.397,1.374,0.023
5,2363,1876,487,1.904,1.511,0.392
5,1603,1682,-79,1.291,1.355,-0.064
5,1723,2208,-485,1.388,1.779,-0.391
5,2200,1957,243,1.772,1.577,0.196
5,2429,2032,397,1.957,1.637,0.320
5,2137,1865,272,1.722,1.502,0.219
5,2109,1965,144,1.699,1.583,0.116
5,2326,1456,870,1.874,1.173,0.701
5,1948,2079,-131,1.569,1.675,-0.106
5,2235,1989,246,1.800,1.602,0.198
5,1575,1649,-74,1.269,1.328,-0.060
5,2200,1809,391,1.772,1.457,0.315
5,2144,1690,454,1.727,1.361,0.366
5,2024,2079,-55,1.631,1.675,-0.044
5,1763,1869,-106,1.420,1.506,-0.085
5,2252,2249,3,1.814,1.812,0.002
5,2283,1883,400,1.839,1.517,0.322
5,1705,2331,-626,1.374,1.878,-0.504
5,1707,1460,247,1.375,1.176,0.199
5,1803,2018,-215,1.452,1.626,-0.173
5,1595,1827,-232,1.285,1.472,-0.187
5,1640,1971,-331,1.321,1.588,-0.267
5,2328,1674,654,1.875,1.349,0.527
5,2027,2288,-261,1.633,1.843,-0.210
5,1916,1890,26,1.544,1.523,0.021
5,1864,2172,-308,1.502,1.750,-0.248
5,1945,2121,-176,1.567,1.709,-0.142
5,2213,2112,101,1.783,1.701,0.081
5,1535,2150,-615,1.237,1.732,-0.495
5,1735,2048,-313,1.398,1.650,-0.252
5,1775,1700,75,1.430,1.369,0.060
5,1729,1990,-261,1.393,1.603,-0.210
5,2182,1884,298,1.758,1.518,0.240
5,2226,1722,504,1.793,1.387,0.406
5,2212,1650,562,1.782,1.329,0.453
5,1730,2084,-354,1.394,1.679,-0.285
5,1964,1829,135,1.582,1.473,0.109
5,2055,1706,349,1.655,1.374,0.281
5,2188,2241,-53,1.763,1.805,-0.043
5,2068,1934,134,1.666,1.558,0.108
5,1710,1504,206,1.378,1.212,0.166
5,1739,2153,-414,1.401,1.734,-0.334
5,1669,1621,48,1.345,1.306,0.039
5,2220,1762,458,1.788,1.419,0.369
5,2202,2209,-7,1.774,1.780,-0.006
5,1519,1745,-226,1.224,1.406,-0.182
5,1511,1935,-424,1.217,1.559,-0.342
5,2112,2058,54,1.701,1.658,0.044
5,2259,1910,349,1.820,1.539,0.281
5,1829,1517,312,1.473,1.222,0.251
5,2058,1700,358,1.658,1.369,0.288
5,1983,1787,196,1.597,1.440,0.158
5,1599,1865,-266,1.288,1.502,-0.214
5,1883,1940,-57,1.517,1.563,-0.046
5,2084,1791,293,1.679,1.443,0.236
5,2235,2134,101,1.800,1.719,0.081
5,1705,2327,-622,1.374,1.875,-0.501
5,2097,1708,389,1.689,1.376,0.313
5,1787,2156,-369,1.440,1.737,-0.297
5,1937,2000,-63,1.560,1.611,-0.051
5,1876,1788,88,1.511,1.440,0.071
5,1818,2176,-358,1.465,1.753,-0.288
5,2113,2008,105,1.702,1.618,0.085
5,1738,2156,-418,1.400,1.737,-0.337
5,2196,1846,350,1.769,1.487,0.282
5,1965,1671,294,1.583,1.346,0.237
5,1944,1662,282,1.566,1.339,0.227
5,2424,1598,826,1.953,1.287,0.665
5,1830,1843,-13,1.474,1.485,-0.010
5,1776,1841,-65,1.431,1.483,-0.052
5,1868,1720,148,1.505,1.386,0.119
5,1539,1457,82,1.240,1.174,0.066
5,1853,1924,-71,1.493,1.550,-0.057
5,2424,1556,868,1.953,1.253,0.699
5,1743,1554,189,1.404,1.252,0.152
5,2168,1558,610,1.747,1.255,0.491
5,1595,1919,-324,1.285,1.546,-0.261
5,2266,1911,355,1.825,1.539,0.286
5,2044,1688,356,1.647,1.360,0.287
5,1915,2034,-119,1.543,1.639,-0.096
5,1660,1572,88,1.337,1.266,0.071
5,2128,1922,206,1.714,1.548,0.166
5,2164,1662,502,1.743,1.339,0.404
5,2213,1765,448,1.783,1.422,0.361
5,2103,1500,603,1.694,1.208,0.486
5,2308,1715,593,1.859,1.382,0.478
5,1649,1779,-130,1.328,1.433,-0.105
5,1705,1932,-227,1.374,1.556,-0.183
5,2114,1658,456,1.703,1.336,0.367
5,1929,2308,-379,1.554,1.859,-0.305
5,2135,1984,151,1.720,1.598,0.122
5,2230,1933,297,1.796,1.557,0.239
5,2391,1775,616,1.926,1.430,0.496
5,1919,1823,96,1.546,1.469,0.077
5,1645,2162,-517,1.325,1.742,-0.416
5,2093,1496,597,1.686,1.205,0.481
5,2416,1912,504,1.946,1.540,0.406
5,2146,1519,627,1.729,1.224,0.505
5,1973,2233,-260,1.589,1.799,-0.209
5,1910,1966,-56,1.539,1.584,-0.045
5,1801,2179,-378,1.451,1.755,-0.305
5,1708,2018,-310,1.376,1.626,-0.250
5,2116,2166,-50,1.705,1.745,-0.040
5,1637,2211,-574,1.319,1.781,-0.462
5,1635,2358,-723,1.317,1.900,-0.582
5,1616,2136,-520,1.302,1.721,-0.419
5,1765,2024,-259,1.422,1.631,-0.209
5,1905,2161,-256,1.535,1.741,-0.206
5,1847,2102,-255,1.488,1.693,-0.205
5,2296,1847,449,1.850,1.488,0.362
5,1771,1830,-59,1.427,1.474,-0.048
5,2171,2056,115,1.749,1.656,0.093
5,1670,1834,-164,1.345,1.477,-0.132
5,1695,1816,-121,1.365,1.463,-0.097
5,2410,2193,217,1.941,1.767,0.175
5,2390,2191,199,1.925,1.765,0.160
5,2017,2330,-313,1.625,1.877,-0.252
5,2007,2113,-106,1.617,1.702,-0.085
5,1796,1999,-203,1.447,1.610,-0.164
5,2038,1843,195,1.642,1.485,0.157
5,1917,1773,144,1.544,1.428,0.116
5,1596,2064,-468,1.286,1.663,-0.377
5,1630,1852,-222,1.313,1.492,-0.179
5,1979,1682,297,1.594,1.355,0.239
5,1659,1885,-226,1.336,1.519,-0.182
5,2118,2072,46,1.706,1.669,0.037
5,1800,1994,-194,1.450,1.606,-0.156
5,1679,2197,-518,1.353,1.770,-0.417
5,2298,2048,250,1.851,1.650,0.201
5,2240,1476,764,1.805,1.189,0.615
5,2073,2030,43,1.670,1.635,0.035
5,1944,1712,232,1.566,1.379,0.187
5,1594,1603,-9,1.284,1.291,-0.007
5,1629,2051,-422,1.312,1.652,-0.340
5,1575,2246,-671,1.269,1.809,-0.541
5,1616,2020,-404,1.302,1.627,-0.325
5,2221,1657,564,1.789,1.335,0.454
5,1791,2151,-360,1.443,1.733,-0.290
5,2087,2346,-259,1.681,1.890,-0.209
5,1752,2272,-520,1.411,1.830,-0.419
5,1735,1752,-17,1.398,1.411,-0.014
5,2082,1878,204,1.677,1.513,0.164
5,1900,2199,-299,1.531,1.771,-0.241
5,2229,2270,-41,1.796,1.829,-0.033
5,1577,1997,-420,1.270,1.609,-0.338
5,1827,1582,245,1.472,1.274,0.197
5,1503,1518,-15,1.211,1.223,-0.012
5,2006,2318,-312,1.616,1.867,-0.251
5,1986,1846,140,1.600,1.487,0.113
5,2180,1775,405,1.756,1.430,0.326
5,1798,1763,35,1.448,1.420,0.028
5,1687,1907,-220,1.359,1.536,-0.177
5,1820,1969,-149,1.466,1.586,-0.120
5,1966,1920,46,1.584,1.547,0.037
5,1543,1968,-425,1.243,1.585,-0.342
5,2313,2163,150,1.863,1.742,0.121
5,2152,2207,-55,1.734,1.778,-0.044
5,1831,1840,-9,1.475,1.482,-0.007
5,1948,1761,187,1.569,1.419,0.151
5,2248,2138,110,1.811,1.722,0.089
5,1968,1829,139,1.585,1.473,0.112
5,1959,1866,93,1.578,1.503,0.075
5,2212,1490,722,1.782,1.200,0.582
5,1674,2202,-528,1.349,1.774,-0.425
5,1826,2030,-204,1.471,1.635,-0.164
5,2423,2000,423,1.952,1.611,0.341
5,1885,1845,40,1.519,1.486,0.032
5,1718,1929,-211,1.384,1.554,-0.170
5,1597,2319,-722,1.287,1.868,-0.582
5,1989,2197,-208,1.602,1.770,-0.168
5,2234,1927,307,1.800,1.552,0.247
5,1687,1852,-165,1.359,1.492,-0.133
5,1821,2070,-249,1.467,1.668,-0.201
5,1631,1984,-353,1.314,1.598,-0.284
5,2172,2167,5,1.750,1.746,0.004
5,2045,1990,55,1.647,1.603,0.044
5,1864,1667,197,1.502,1.343,0.159
5,1907,2161,-254,1.536,1.741,-0.205
5,2291,1837,454,1.846,1.480,0.366
5,1701,2008,-307,1.370,1.618,-0.247
5,1929,1678,251,1.554,1.352,0.202
5,2011,2365,-354,1.620,1.905,-0.285
5,1979,1779,200,1.594,1.433,0.161
5,2270,1948,322,1.829,1.569,0.259
5,2183,1926,257,1.759,1.552,0.207
5,1890,2048,-158,1.523,1.650,-0.127
5,2284,1869,415,1.840,1.506,0.334
5,2102,1478,624,1.693,1.191,0.503
5,1755,2179,-424,1.414,1.755,-0.342
5,2158,1597,561,1.738,1.287,0.452
5,1824,1970,-146,1.469,1.587,-0.118
5,1796,2153,-357,1.447,1.734,-0.288
5,1919,1913,6,1.546,1.541,0.005
5,2155,1750,405,1.736,1.410,0.326
5,2235,1825,410,1.800,1.470,0.330
5,1837,2140,-303,1.480,1.724,-0.244
5,2011,1756,255,1.620,1.415,0.205
5,1730,2033,-303,1.394,1.638,-0.244
5,2227,1671,556,1.794,1.346,0.448
5,1894,1938,-44,1.526,1.561,-0.035
5,1963,1921,42,1.581,1.548,0.034
5,2147,2077,70,1.730,1.673,0.056
5,1940,1862,78,1.563,1.500,0.063
5,2096,1488,608,1.689,1.199,0.490
5,1923,2332,-409,1.549,1.879,-0.329
5,2110,2210,-100,1.700,1.780,-0.081
5,1717,2231,-514,1.383,1.797,-0.414
5,1901,1591,310,1.531,1.282,0.250
5,2243,2147,96,1.807,1.730,0.077
5,1714,1827,-113,1.381,1.472,-0.091
5,2364,1693,671,1.904,1.364,0.541
5,2225,2165,60,1.792,1.744,0.048
5,1896,1801,95,1.527,1.451,0.077
5,2041,1853,188,1.644,1.493,0.151
5,2024,1678,346,1.631,1.352,0.279
5,2270,1660,610,1.829,1.337,0.491
5,1840,1848,-8,1.482,1.489,-0.006
5,2029,2190,-161,1.635,1.764,-0.130
5,2075,2279,-204,1.672,1.836,-0.164
5,2262,2213,49,1.822,1.783,0.039
5,2099,1485,614,1.691,1.196,0.495
5,2014,2200,-186,1.622,1.772,-0.150
5,1914,2001,-87,1.542,1.612,-0.070
5,1923,1617,306,1.549,1.303,0.247
5,2053,1917,136,1.654,1.544,0.110
5,1922,2184,-262,1.548,1.759,-0.211
5,2124,1965,159,1.711,1.583,0.128
5,2005,2051,-46,1.615,1.652,-0.037
5,1822,2030,-208,1.468,1.635,-0.168
5,2173,1505,668,1.751,1.212,0.538
5,1793,2356,-563,1.444,1.898,-0.454
5,1659,2023,-364,1.336,1.630,-0.293
5,1699,1545,154,1.369,1.245,0.124
5,1690,2156,-466,1.361,1.737,-0.375
5,2392,1920,472,1.927,1.547,0.380
5,1903,1709,194,1.533,1.377,0.156
5,1924,1841,83,1.550,1.483,0.067
5,1658,1722,-64,1.336,1.387,-0.052
5,1911,1818,93,1.539,1.465,0.075
5,2104,1489,615,1.695,1.200,0.495
5,1721,1986,-265,1.386,1.600,-0.213
5,1871,1834,37,1.507,1.477,0.030
5,1597,1757,-160,1.287,1.415,-0.129
5,2246,1476,770,1.809,1.189,0.620
5,1867,1933,-66,1.504,1.557,-0.053
5,2058,1767,291,1.658,1.423,0.234
5,2356,1988,368,1.898,1.602,0.296
5,1657,1889,-232,1.335,1.522,-0.187
5,1547,1551,-4,1.246,1.249,-0.003
5,1730,1527,203,1.394,1.230,0.164
5,1817,2016,-199,1.464,1.624,-0.160
5,1790,2346,-556,1.442,1.890,-0.448
5,1975,1832,143,1.591,1.476,0.115
5,1707,1952,-245,1.375,1.573,-0.197
5,2039,1577,462,1.643,1.270,0.372
5,1912,1501,411,1.540,1.209,0.331
5,1985,2286,-301,1.599,1.842,-0.242
5,2272,1815,457,1.830,1.462,0.368
5,2046,1645,401,1.648,1.325,0.323
5,2201,2201,0,1.773,1.773,0.000
5,1770,2030,-260,1.426,1.635,-0.209
5,2174,2024,150,1.751,1.631,0.121
5,1542,1954,-412,1.242,1.574,-0.332
5,1780,1783,-3,1.434,1.436,-0.002
5,2061,2160,-99,1.660,1.740,-0.080
5,2250,2044,206,1.813,1.647,0.166
5,1765,2075,-310,1.422,1.672,-0.250
5,2066,1564,502,1.664,1.260,0.404
5,1694,2204,-510,1.365,1.776,-0.411
5,1828,1678,150,1.473,1.352,0.121
5,2071,2225,-154,1.668,1.792,-0.124
5,1793,1944,-151,1.444,1.566,-0.122
5,1829,1835,-6,1.473,1.478,-0.005
5,2068,2067,1,1.666,1.665,0.001
5,2418,1901,517,1.948,1.531,0.416
5,1864,1659,205,1.502,1.336,0.165
5,2055,2001,54,1.655,1.612,0.044
5,2198,1844,354,1.771,1.485,0.285
5,2075,1773,302,1.672,1.428,0.243
5,1893,1843,50,1.525,1.485,0.040
5,1543,2114,-571,1.243,1.703,-0.460
5,1995,2040,-45,1.607,1.643,-0.036
5,1510,1935,-425,1.216,1.559,-0.342
5,2216,1868,348,1.785,1.505,0.280
5,1584,1854,-270,1.276,1.494,-0.218
5,1916,2092,-176,1.544,1.685,-0.142
5,1875,2125,-250,1.510,1.712,-0.201
5,1947,1916,31,1.568,1.544,0.025
5,1837,1856,-19,1.480,1.495,-0.015
5,1624,2200,-576,1.308,1.772,-0.464
5,1815,2276,-461,1.462,1.834,-0.371
5,2264,2156,108,1.824,1.737,0.087
5,1735,1527,208,1.398,1.230,0.168
5,1955,2015,-60,1.575,1.623,-0.048
5,1746,2154,-408,1.407,1.735,-0.329
5,2197,2354,-157,1.770,1.896,-0.126
5,1660,2384,-724,1.337,1.921,-0.583
5,1905,2106,-201,1.535,1.697,-0.162
5,1619,2093,-474,1.304,1.686,-0.382
5,2130,1531,599,1.716,1.233,0.483
5,1618,1943,-325,1.303,1.565,-0.262
5,1883,1479,404,1.517,1.191,0.325
5,2242,2137,105,1.806,1.722,0.085
5,2120,1673,447,1.708,1.348,0.360
5,1809,2222,-413,1.457,1.790,-0.333
5,1796,2111,-315,1.447,1.701,-0.254
5,2147,1890,257,1.730,1.523,0.207
5,1915,1508,407,1.543,1.215,0.328
5,1945,2110,-165,1.567,1.700,-0.133
5,1487,2113,-626,1.198,1.702,-0.504
5,2252,1944,308,1.814,1.566,0.248
5,1828,1799,29,1.473,1.449,0.023
5,2043,2100,-57,1.646,1.692,-0.046
5,2197,1752,445,1.770,1.411,0.358
5,1529,1700,-171,1.232,1.369,-0.138
5,1578,2062,-484,1.271,1.661,-0.390
5,2258,1606,652,1.819,1.294,0.525
5,2318,1760,558,1.867,1.418,0.450
5,2213,2073,140,1.783,1.670,0.113
5,2110,2116,-6,1.700,1.705,-0.005
5,2108,1874,234,1.698,1.510,0.189
5,1950,1976,-26,1.571,1.592,-0.021
5,1506,1575,-69,1.213,1.269,-0.056
5,2074,1988,86,1.671,1.602,0.069
5,1972,1476,496,1.589,1.189,0.400
5,1976,1983,-7,1.592,1.597,-0.006
5,1823,2242,-419,1.469,1.806,-0.338
5,1509,1835,-326,1.216,1.478,-0.263
5,1500,1924,-424,1.208,1.550,-0.342
5,1861,1675,186,1.499,1.349,0.150
5,1810,1462,348,1.458,1.178,0.280
5,2165,2225,-60,1.744,1.792,-0.048
5,1804,1882,-78,1.453,1.516,-0.063
5,1495,1674,-179,1.204,1.349,-0.144
5,1701,1656,45,1.370,1.334,0.036
5,1738,1605,133,1.400,1.293,0.107
5,1995,1707,288,1.607,1.375,0.232
5,1785,1638,147,1.438,1.320,0.118
5,1727,2095,-368,1.391,1.688,-0.296
5,1627,1788,-161,1.311,1.440,-0.130
5,1607,1922,-315,1.295,1.548,-0.254
5,1758,1877,-119,1.416,1.512,-0.096
5,2007,2366,-359,1.617,1.906,-0.289
5,1683,2252,-569,1.356,1.814,-0.458
5,2032,2135,-103,1.637,1.720,-0.083
5,1552,2228,-676,1.250,1.795,-0.545
5,2059,1910,149,1.659,1.539,0.120
5,1577,1584,-7,1.270,1.276,-0.006
5,2238,1889,349,1.803,1.522,0.281
5,1764,2228,-464,1.421,1.795,-0.374
5,1803,2116,-313,1.452,1.705,-0.252
5,1745,1601,144,1.406,1.290,0.116
5,1898,1898,0,1.529,1.529,0.000
5,2336,1827,509,1.882,1.472,0.410
5,2052,1811,241,1.653,1.459,0.194
5,2248,1694,554,1.811,1.365,0.446
5,2085,1935,150,1.680,1.559,0.121
5,1819,1556,263,1.465,1.253,0.212
5,2202,2096,106,1.774,1.689,0.085
5,2076,1570,506,1.672,1.265,0.408
5,1966,2389,-423,1.584,1.925,-0.341
5,2371,2160,211,1.910,1.740,0.170
5,2249,1845,404,1.812,1.486,0.325
5,2068,1767,301,1.666,1.423,0.242
5,2251,2201,50,1.813,1.773,0.040
5,1724,1634,90,1.389,1.316,0.073
5,2226,2172,54,1.793,1.750,0.044
5,1857,1867,-10,1.496,1.504,-0.008
5,1793,1799,-6,1.444,1.449,-0.005
5,1874,2286,-412,1.510,1.842,-0.332
5,2266,2162,104,1.825,1.742,0.084
5,2195,1635,560,1.768,1.317,0.451
5,2072,2227,-155,1.669,1.794,-0.125
5,1751,1919,-168,1.411,1.546,-0.135
5,1836,2037,-201,1.479,1.641,-0.162
5,2432,1724,708,1.959,1.389,0.570
5,2114,1454,660,1.703,1.171,0.532
5,2168,2065,103,1.747,1.664,0.083
5,1898,1498,400,1.529,1.207,0.322
5,2409,2201,208,1.941,1.773,0.168
5,1915,2239,-324,1.543,1.804,-0.261
5,1606,1666,-60,1.294,1.342,-0.048
5,2318,1768,550,1.867,1.424,0.443
5,1850,2054,-204,1.490,1.655,-0.164
5,2035,1787,248,1.639,1.440,0.200
5,2134,1475,659,1.719,1.188,0.531
5,2428,1712,716,1.956,1.379,0.577
5,2308,1475,833,1.859,1.188,0.671
5,1969,1933,36,1.586,1.557,0.029
5,1495,2173,-678,1.204,1.751,-0.546
5,2365,1698,667,1.905,1.368,0.537
5,2352,1981,371,1.895,1.596,0.299
5,1947,1922,25,1.568,1.548,0.020
5,1735,1907,-172,1.398,1.536,-0.139
5,1922,1878,44,1.548,1.513,0.035
5,2220,2070,150,1.788,1.668,0.121
5,1903,2211,-308,1.533,1.781,-0.248
5,2195,1892,303,1.768,1.524,0.244
5,1762,1969,-207,1.419,1.586,-0.167
5,1679,1489,190,1.353,1.200,0.153
5,2072,2216,-144,1.669,1.785,-0.116
5,1932,1691,241,1.556,1.362,0.194
5,1823,2075,-252,1.469,1.672,-0.203
5,2054,1643,411,1.655,1.324,0.331
5,1663,2023,-360,1.340,1.630,-0.290
5,1489,1962,-473,1.200,1.581,-0.381
5,2267,1908,359,1.826,1.537,0.289
5,1873,1980,-107,1.509,1.595,-0.086
5,1699,2219,-520,1.369,1.788,-0.419
5,1839,1791,48,1.481,1.443,0.039
5,1652,1671,-19,1.331,1.346,-0.015
5,2368,1747,621,1.908,1.407,0.500
5,2240,1679,561,1.805,1.353,0.452
5,1919,1724,195,1.546,1.389,0.157
5,1899,1999,-100,1.530,1.610,-0.081
5,1524,1692,-168,1.228,1.363,-0.135
5,2349,1625,724,1.892,1.309,0.583
5,1947,2017,-70,1.568,1.625,-0.056
5,2277,1881,396,1.834,1.515,0.319
5,1535,1924,-389,1.237,1.550,-0.313
5,1743,1854,-111,1.404,1.494,-0.089
5,1675,2299,-624,1.349,1.852,-0.503
5,1623,1984,-361,1.307,1.598,-0.291
5,1711,2232,-521,1.378,1.798,-0.420
5,2430,2173,257,1.958,1.751,0.207
5,1909,1768,141,1.538,1.424,0.114
5,1639,2051,-412,1.320,1.652,-0.332
5,2249,1811,438,1.812,1.459,0.353
5,2050,2052,-2,1.651,1.653,-0.002
5,1736,2168,-432,1.398,1.747,-0.348
5,2266,1964,302,1.825,1.582,0.243
5,1893,2304,-411,1.525,1.856,-0.331
5,2089,1784,305,1.683,1.437,0.246
5,2022,2181,-159,1.629,1.757,-0.128
5,2165,2058,107,1.744,1.658,0.086
5,2349,2245,104,1.892,1.809,0.084
5,2179,1565,614,1.755,1.261,0.495
5,2374,1715,659,1.912,1.382,0.531
5,1791,2156,-365,1.443,1.737,-0.294
5,1983,2139,-156,1.597,1.723,-0.126
5,2232,2136,96,1.798,1.721,0.077
5,1867,2220,-353,1.504,1.788,-0.284
5,1791,2140,-349,1.443,1.724,-0.281
5,2240,1929,311,1.805,1.554,0.251
5,1967,1768,199,1.585,1.424,0.160
5,1751,2110,-359,1.411,1.700,-0.289
5,2360,1896,464,1.901,1.527,0.374
5,1759,2118,-359,1.417,1.706,-0.289
5,2112,1823,289,1.701,1.469,0.233
5,1923,1521,402,1.549,1.225,0.324
5,1799,2369,-570,1.449,1.908,-0.459
5,1778,1783,-5,1.432,1.436,-0.004
5,1547,1925,-378,1.246,1.551,-0.305
5,2252,2196,56,1.814,1.769,0.045
5,2178,1510,668,1.755,1.216,0.538
5,1699,2007,-308,1.369,1.617,-0.248
5,2153,1855,298,1.734,1.494,0.240
5,2076,2069,7,1.672,1.667,0.006
5,2219,2166,53,1.788,1.745,0.043
5,1727,1845,-118,1.391,1.486,-0.095
5,1614,1976,-362,1.300,1.592,-0.292
5,1703,2058,-355,1.372,1.658,-0.286
5,1931,1474,457,1.556,1.187,0.368
5,1972,1626,346,1.589,1.310,0.279
5,1903,1918,-15,1.533,1.545,-0.012
5,2044,1847,197,1.647,1.488,0.159
5,1879,2139,-260,1.514,1.723,-0.209
5,2083,1776,307,1.678,1.431,0.247
5,2268,1615,653,1.827,1.301,0.526
5,1649,1703,-54,1.328,1.372,-0.044
5,1841,1477,364,1.483,1.190,0.293
5,1606,1960,-354,1.294,1.579,-0.285
5,2105,2364,-259,1.696,1.904,-0.209
5,1773,2388,-615,1.428,1.924,-0.495
5,1849,1909,-60,1.490,1.538,-0.048
5,1821,1568,253,1.467,1.263,0.204
5,2165,2000,165,1.744,1.611,0.133
5,1984,1680,304,1.598,1.353,0.245
5,2062,2168,-106,1.661,1.747,-0.085
5,2050,1846,204,1.651,1.487,0.164
5,2073,2126,-53,1.670,1.713,-0.043
5,2060,2107,-47,1.660,1.697,-0.038
5,1686,2043,-357,1.358,1.646,-0.288
5,1552,1614,-62,1.250,1.300,-0.050
5,2366,1908,458,1.906,1.537,0.369
5,2406,2292,114,1.938,1.846,0.092
5,2176,1927,249,1.753,1.552,0.201
5,1924,1479,445,1.550,1.191,0.358
5,1769,2289,-520,1.425,1.844,-0.419
5,1601,1660,-59,1.290,1.337,-0.048
5,1528,1801,-273,1.231,1.451,-0.220
5,1620,1679,-59,1.305,1.353,-0.048
5,2161,1707,454,1.741,1.375,0.366
5,1886,1634,252,1.519,1.316,0.203
5,2176,1923,253,1.753,1.549,0.204
5,1887,2195,-308,1.520,1.768,-0.248
5,2130,1685,445,1.716,1.357,0.358
5,2076,2124,-48,1.672,1.711,-0.039
5,2009,1661,348,1.618,1.338,0.280
5,2312,2220,92,1.863,1.788,0.074
5,2355,2147,208,1.897,1.730,0.168
5,2188,2334,-146,1.763,1.880,-0.118
5,2224,1771,453,1.792,1.427,0.365
5,1788,1992,-204,1.440,1.605,-0.164
5,1717,1974,-257,1.383,1.590,-0.207
5,1907,2162,-255,1.536,1.742,-0.205
5,2250,2231,19,1.813,1.797,0.015
5,2381,2217,164,1.918,1.786,0.132
5,2104,1688,416,1.695,1.360,0.335
5,1599,2382,-783,1.288,1.919,-0.631
5,1580,2042,-462,1.273,1.645,-0.372
5,1664,1778,-114,1.340,1.432,-0.092
5,2001,1751,250,1.612,1.411,0.201
5,1873,2235,-362,1.509,1.800,-0.292
5,2222,1813,409,1.790,1.461,0.329
5,1781,1789,-8,1.435,1.441,-0.006
5,2119,2003,116,1.707,1.614,0.093
5,2304,2097,207,1.856,1.689,0.167
5,1815,1776,39,1.462,1.431,0.031
5,1738,2027,-289,1.400,1.633,-0.233
5,2106,2096,10,1.697,1.689,0.008
5,1716,2331,-615,1.382,1.878,-0.495
5,2421,1862,559,1.950,1.500,0.450
5,2241,2296,-55,1.805,1.850,-0.044
5,1867,2227,-360,1.504,1.794,-0.290
5,2267,1811,456,1.826,1.459,0.367
5,1775,2342,-567,1.430,1.887,-0.457
5,1851,2107,-256,1.491,1.697,-0.206
5,2245,2192,53,1.809,1.766,0.043
5,1966,2015,-49,1.584,1.623,-0.039
5,1897,1850,47,1.528,1.490,0.038
5,2345,1782,563,1.889,1.436,0.454
5,2418,1914,504,1.948,1.542,0.406
5,1914,2193,-279,1.542,1.767,-0.225
5,1923,1829,94,1.549,1.473,0.076
5,1805,1864,-59,1.454,1.502,-0.048
5,2202,1898,304,1.774,1.529,0.245
5,1767,2080,-313,1.423,1.676,-0.252
5,2013,1872,141,1.622,1.508,0.114
5,1692,1912,-220,1.363,1.540,-0.177
5,2152,1758,394,1.734,1.416,0.317
5,1883,1845,38,1.517,1.486,0.031
5,1912,1661,251,1.540,1.338,0.202
5,1697,1650,47,1.367,1.329,0.038
5,2248,1789,459,1.811,1.441,0.370
5,1620,2096,-476,1.305,1.689,-0.383
5,2290,2040,250,1.845,1.643,0.201
5,2130,2181,-51,1.716,1.757,-0.041
5,2006,2369,-363,1.616,1.908,-0.292
5,1924,1931,-7,1.550,1.556,-0.006
5,1955,1763,192,1.575,1.420,0.155
5,2092,1697,395,1.685,1.367,0.318
5,1879,1988,-109,1.514,1.602,-0.088
5,2288,1790,498,1.843,1.442,0.401
5,1919,1722,197,1.546,1.387,0.159
5,1856,2064,-208,1.495,1.663,-0.168
5,1792,2308,-516,1.444,1.859,-0.416
5,1825,1632,193,1.470,1.315,0.155
5,1821,2234,-413,1.467,1.800,-0.333
5,1554,1456,98,1.252,1.173,0.079
5,2048,2369,-321,1.650,1.908,-0.259
5,1635,2116,-481,1.317,1.705,-0.387
5,1794,2109,-315,1.445,1.699,-0.254
5,1896,1853,43,1.527,1.493,0.035
5,1921,1849,72,1.548,1.490,0.058
5,1827,2190,-363,1.472,1.764,-0.292
5,2391,1683,708,1.926,1.356,0.570
5,1817,2288,-471,1.464,1.843,-0.379
5,2224,1969,255,1.792,1.586,0.205
5,2222,2279,-57,1.790,1.836,-0.046
5,2424,1968,456,1.953,1.585,0.367
5,2060,1965,95,1.660,1.583,0.077
5,2377,2173,204,1.915,1.751,0.164
5,1550,2280,-730,1.249,1.837,-0.588
5,2007,2173,-166,1.617,1.751,-0.134
5,1807,2126,-319,1.456,1.713,-0.257
5,1964,1720,244,1.582,1.386,0.197
5,1962,2074,-112,1.581,1.671,-0.090
5,2284,1827,457,1.840,1.472,0.368
5,1703,1503,200,1.372,1.211,0.161
5,2115,1716,399,1.704,1.382,0.321
5,2055,2168,-113,1.655,1.747,-0.091
5,2211,1663,548,1.781,1.340,0.441
5,1791,1912,-121,1.443,1.540,-0.097
5,1840,1912,-72,1.482,1.540,-0.058
5,2037,2198,-161,1.641,1.771,-0.130
5,2398,2294,104,1.932,1.848,0.084
5,2022,1893,129,1.629,1.525,0.104
5,2022,1970,52,1.629,1.587,0.042
5,1813,1778,35,1.461,1.432,0.028
5,2016,1920,96,1.624,1.547,0.077
5,1647,1831,-184,1.327,1.475,-0.148
5,1859,1912,-53,1.498,1.540,-0.043
5,2054,1921,133,1.655,1.548,0.107
5,2205,2054,151,1.776,1.655,0.122
5,1915,2079,-164,1.543,1.675,-0.132
5,2284,2387,-103,1.840,1.923,-0.083
5,1497,1771,-274,1.206,1.427,-0.221
5,1746,1992,-246,1.407,1.605,-0.198
5,1620,1935,-315,1.305,1.559,-0.254
5,2028,2028,0,1.634,1.634,0.000
5,2121,1960,161,1.709,1.579,0.130
5,2214,1919,295,1.784,1.546,0.238
5,2106,2213,-107,1.697,1.783,-0.086
5,1881,2187,-306,1.515,1.762,-0.247
5,2233,1928,305,1.799,1.553,0.246
5,2168,1663,505,1.747,1.340,0.407
5,2212,2114,98,1.782,1.703,0.079
5,2098,2149,-51,1.690,1.731,-0.041
5,2286,2025,261,1.842,1.631,0.210
5,2064,2065,-1,1.663,1.664,-0.001
5,2365,1758,607,1.905,1.416,0.489
5,2146,1748,398,1.729,1.408,0.321
5,2295,1689,606,1.849,1.361,0.488
5,1724,2246,-522,1.389,1.809,-0.421
5,1675,1742,-67,1.349,1.403,-0.054
5,1977,1520,457,1.593,1.224,0.368
5,1596,1503,93,1.286,1.211,0.075
5,1581,1905,-324,1.274,1.535,-0.261
5,2036,1791,245,1.640,1.443,0.197
5,2228,2385,-157,1.795,1.921,-0.126
5,1488,2159,-671,1.199,1.739,-0.541
5,1887,1989,-102,1.520,1.602,-0.082
5,2227,1499,728,1.794,1.208,0.586
5,2256,1537,719,1.817,1.238,0.579
5,2025,2283,-258,1.631,1.839,-0.208
5,1801,2054,-253,1.451,1.655,-0.204
5,1673,2290,-617,1.348,1.845,-0.497
5,1757,2314,-557,1.415,1.864,-0.449
5,1734,2137,-403,1.397,1.722,-0.325
5,1917,2265,-348,1.544,1.825,-0.280
5,1999,1701,298,1.610,1.370,0.240
5,2088,2129,-41,1.682,1.715,-0.033
5,1486,1857,-371,1.197,1.496,-0.299
5,1723,1988,-265,1.388,1.602,-0.213
5,1969,2238,-269,1.586,1.803,-0.217
